O O O O O O O O O O O O O O B-Medication O O O	@USER spoke with my nurse this morning ! We adjusted the rate on my zofran pump . :)
O O O O O O B-Medication O O O B-Medication I-Medication O O O O O O O O O O O O O O O O	@USER I'm not allowe to take laxatives so I take fiber gummies , which are sexy and exotic because here they're fibre gummies . Oh la la !
O O O O O O O O O O O O O O O O O O B-Medication I-Medication	@USER ğŸ˜‚ ğŸ˜‚ ğŸ˜‚ I hope that don't happen to me I'm running until I get back on birth control
B-Medication O O	Tums are triflin
O O O B-Medication I-Medication O O	Bouta take some night quil ğŸ¤˜ ğŸ½
O O B-Medication	@USER @USER sudafed
O O O O O O O O O O O O O O O O O O O O O O O B-Medication O	when you get given the worst cough in the universe and all you can take is honey and lemon with a side of paracetamol ğŸ˜‘
O O O B-Medication O O O O O	Should have taken Benadryl .. I need sleep !
O O O O O O O O O O O O O O O O O O O O O B-Medication O O O O	I woke up with the sorest throat and stiffest neck today . It actually feels worse now . Blah . # Advil # bed # ihateviruses
O O O O O O O O B-Medication O O O O O O O	I'm really chilling out on taking these damn Benadryls at night , they're becoming addictive .
O O O B-Medication O O O O O	Then got an epidural ğŸ™‹ â€ â™€ ï¸ ğŸ‘
O O O B-Medication O O O O O O O O O O O O O O O O O O O O O O O O O O O O O	@USER i hated depo , so i switched as soon as i could . And yeah ! it works for up to 3 years and you don't even notice it . I've heard
O O O O O O O O O O O O O O O O O O O O O O O O O O B-Medication O O O O O	@USER sorry you're suffering . ğŸ˜” I lost 35 pounds in January due to HG . Now , I'm 22 weeks & doing well with a zofran pump . I hope your
O O O O O B-Medication O	Broke my water and started pitocin ğŸ˜
O O O O O O O O O O O O O O B-Medication I-Medication I-Medication O O O O O O O O O O O	Okay , Soooo . . . I have a real-life friend who has started injections for IVF ! ! ! Please , please , please throw ... URL
O O O B-Medication O O O O O O O O B-Medication O O O O	@USER Watch the Tylenol ingestion with the day / night pills and acetaminophen together ! # nerdalert
O O O O O O O O B-Medication O	Yoooo , can somebody drop me off a Benadryl ?
O O O O O O O B-Medication I-Medication I-Medication O O O O O O O O O O O	Take advantage of the NEW @USER Redline White Heat Preworkout Promo ! URL # vpx # preworkout # fitness # whiteheat
O O O O O O B-Medication O O O O O O O O O O O O O O O O O O O O O O	I did my first injection of Lupron today :D Feeling sooo proud of myself for being able to do it on my own ! ! ! I ... URL
O O O O O O O O O O O O O O O O O O O O O O O O O O O O O B-Medication	Woke up abruptly and panicking because I heard beeping . I thought it was an alarm . It was just time for a syringe change .. hah ! # zofranpump
B-Medication O O O O O O O O	Prenatals are doing magic to my hair ğŸ˜ ğŸ˜
O O O O O O O O B-Medication O O O O O O O O O O O O O O O O O	I was definitely a lot faster prepping my Menopur . . . much smoother today , but my poor belly is starting to look ... URL
O O O O O O O B-Medication O O O O O O O O	@USER That's fantastic ! Did you take aspirin , shots , or nothing during pregnancy ?
O O O O O O O O O O O O O O O O B-Medication O O O O	Y'all ... 18 mg a day is not enough to get through the week . # ConcertaProblems # ADDandPregnant # Thursday
O O O B-Medication O O O O O O O O O O O O O O O O O O O O O O	Sooooo .. my Zofran pump broke for the night . Relying on dissolvables until my new pump arrives . Here's to hoping this goes okay .
O O O O O O B-Medication O O O O	In quite a lot of pain painkilers don't touch it ğŸ˜
O O O O O O O O O O B-Medication O O O O O O O O O O O O	I really really want to cut my hair . These prenatals r keeping it growing and frankly ... It's too damn hot ğŸ”¥
O O O B-Medication O O O O O O O	are the strawberry gaviscon any nicer than the mint ones ?
O O O O O O O O O O O O O O O O O O O O B-Medication O	I love finding out via google that I'm going to be sick for the next week while I'm on this antibiotic ğŸ™ƒ
O O O O O O B-Medication O O O O O O O O O	@USER yeah I kno but that epidural will have yu like wtf where the perks at
O O O O B-Medication O O O O O O O O O O O	I'm so scared my epidural will wear off right before I have to push ğŸ™ˆ ğŸ˜£
O O O O O O O O B-Medication O O O O O B-Medication O O O O O O O O	Please don't tell a woman with HG that Zofran is a big no and Diclegis works perfectly if you take it consistently .
O O O O B-Medication O O O O O O O O O O O O O O O O O O O O O O O	@USER Awesome news ! Warfarin adjustment can be a pain in the butt for the first few weeks / months but hopefully they will level out soon .
O B-Medication O O O O O O O O	@USER Antibiotics make me even more hungry . Piggy :)
O O O O O B-Medication I-Medication O O O O O O O O	i need to get on birth control faaaaaaaassssst because this nigga be trying it ğŸ˜©
O O O O O O O O O B-Medication O O O O O O O O O O O	I was thinking about slipping my dog a little ambien & just pulling her teeth myself . # thingsmymothersays # fb
B-Medication O O O O O O O O O O O O O O	Benadryl , bedtime snack , and New Girl . The party is getting real .
O O B-Medication O O O O O O O O O O O O O O O O O O O O	Taking # Zofran before bed helps me not puke in the morning , but I still feel nauseous all day . # pregnant
O O O O O O O O O O O B-Medication O O	@USER Been there . It sucks . Do you have any Gaviscon ? ?
O O O B-Medication I-Medication O O O O O O O O O	I hate these prenatal vitamins . They are so hard to swallow ğŸ˜­ ğŸ˜­
O O O O B-Medication I-Medication O O O O O O O O O O O O	I don't have my nausea pills for tonight .. so I'm probably going to die tomorrow ... ğŸ˜³
O O O O O O O O O O O O O B-Medication O O O O O O O O O O	@USER because i support weed . not tobacco . not cancer . not nicotine . weed is what you need .. not tobacco .
O O B-Medication O O O O O O O O O O O O	Doling out tums one by one to pregnant ladies is some real bullshit , Vanderbilt
O O O O O O O O O O O O O O O O O O O O O O O O B-Medication	@USER I don't envy you . Sinus congestion / infections / inflammation is so painful . Until you experience it you don't realize # Sudafed
O O O O O O O O O O O B-Medication I-Medication O O O O O O O O O	# WellnessWednesday : 5 Ways to Ease a Hangover ! Shop vitamin B â†’ URL # health # hangover # HumpDay URL
O O O O O O O B-Medication I-Medication O O O O O O O O O O O	# HDSpecial ! @USER : Buy 1 COR Creatine , Get 1 50 % OFF ! Shop Now â†’ URL
O O O B-Medication I-Medication O O O O O O O O O O O O O O O O O	Have you tried Gotu Kola ? There's so many benefits ! Shop now â†’ URL # health # droz # TipTuesday URL
O O O O O O O O O O O O O O O O O O O O O O O O O O B-Medication O	@USER Hope you aren't too swollen tomorrow ! ! ! I've as much as possible for the first 24 hours ! ! And don't skip the Advil ğŸ˜‰
O O O O O O O O O O O O O O O O O O B-Medication O O O O	My man cold from last week had actually progressed to a full fledged ear infection . Hoping these antibiotics kick in soon .
O O O O O B-Medication O O	Retweet if you take # melatonin . URL
O O B-Medication O O O O O O O O O O	# NowPlaying Nicotine and Alcohol Saved My Life by Deaf Havana â™« URL
O O O O O B-Medication O O O O O O O O O O O O O O O O O O O	I'm on day 5 of Lupron and the only significant symptom I'm feeling is that my bones hurt :| My shoulder and hips ... URL
O O O O O O O O O O O O O O B-Medication O O O	Chewing these like a champ to get through this game . # stress # Gaviscon # raptors URL
O O O O O B-Medication O O O O O O O O O O O	Bloody toothache keeping me awake painkillers aren't working swirling brandy isn't working . I need sleep .
O O O O O O O O O B-Medication O O O O O O O O O O O O O O O O O O O	After 17.5 weeks , I said goodbye to my Zofran pump yesterday . I think I'm gonna miss that guy for the rest of this pregnancy . # hglife
O O O O O B-Medication O O O O O O O O O O O O O O O O O O O O O O O O	@USER I don't want an epidural ğŸ˜‚ ğŸ˜‚ ğŸ˜­ I swear I'm sooo serious . I already made my birth plan , I don't want them asking me about an
O O O O O B-Medication O O O O O O O O O O O O O O O O O O O O O O O O O O	@USER Yeah , I got percs . Ion even take them things thou ion like the feeling .. I took one and felt like I was on cloud 1000 .. ğŸ˜‚ ğŸ˜‚
O O O O O O O O O O O O O O O O O O O O B-Medication O O O	I had my eye removed today ! Feels much better ... had som tea and am now sleeping off my anaesthetic :) â€¦ URL
O O O O O B-Medication B-Medication O B-Medication O O O O O O O O O O O O O O	This heartburn is real . Nexium Gaviscon and Tums can't even fight it . Damn wings . They get me every time !
O O O O O O O O O O O O O O O O O O O O O O O B-Medication O O O O	I really don't want to get out but I don't think I'll ever get back to sleep if I don't go buy some tums . ğŸ˜­ ğŸ¤° ğŸ»
O O B-Medication O O O O O O O O	Thank you tylenol for doing absolutely nothing for my contractions ğŸ˜’
O O O O O O O O B-Medication O O O O O O O O O O O O O	I've been so dead set against getting the epidural .. but FUUUUUUUCK this hurts worse than being hit by a car .
O O O O O O O O O O O B-Medication O O O O O O O O O O O O O O O O	@USER I've done the bath tub , heating pad , and Tylenol . They won't go away . It's miserable . I was up all night crying .
O O O O O O O O O O O O B-Medication I-Medication O O O	I'm going to be so drained today I forgot to take my iron pill â˜¹ ï¸ .
O O O O O B-Medication O O O O O O O O O	Jeremiah does a review on Melatonin ! Coming soon on our youtube channel :) URL
O B-Medication O O O O O O O O O O O O O O O O O O O	The ambien kicked in and Karen is here talkin my head off I'm about to throw my remote at her forehead
O O O O O B-Medication O O O O O O O O O O O O	I'm so scared that my epidural is not gonna work ğŸ˜­ ğŸ˜­ I'm in full panic mode .
O O O O O O O O B-Medication I-Medication O O O O O	@USER I even drink it to take my prenatal pills , I'm a weirdo ğŸ˜‚
O O O O O O O O O O O O O O B-Medication I-Medication O O O O O O O	@USER BODY GLIDE before you walk . If it's red and irritated afterwards some Hydrocortisone cream always helps with short term use .
O O O O O O O O O O O O O O O O O O O O O O B-Medication O O O	@USER no they're holding off until 4 bc the nurses didn't give me enough gels last night & started me late on pitosin today ğŸ™„ ğŸ˜­
O O O O O O O O O O O O O B-Medication O O O O O O O	@USER oh lawd ğŸ˜­ ğŸ˜­ that's kinda why I want to get the epidural ğŸ˜© so I won't feel stitches ğŸ˜‚
O O B-Medication O O O O O O O O O O O O O	Sprite and Zantac .. Maybe ğŸ• wasn't the best idea . ğŸ˜‚ # pregnancyissues # itsnotrainbowsandunicorns
O B-Medication I-Medication O O O O O O O O O	My iron pill makes me me feel crappy as heck . ğŸ™„
O O O O O B-Medication O O O	Bout to be in a Benadryl induced coma ğŸ˜´
O O O O O O O B-Medication O O O O	@USER ğŸ¤” ğŸ¤” I might get the IUD then ğŸ˜­ ğŸ˜­ ğŸ˜‚
O O O O B-Medication O O O O	So much information on vaccines . Oh my .
O O O O O O O O O O O O O O O O O O O B-Medication O	Balloon is out and it did its job ... I'm now at 5cm and we've just started a little pitocin :)
O O O B-Medication O O O B-Medication O O O O O O O O O O O O O O O O O O O O O O	I can't stomach prenatals or any other vitamins to help , so being able to stomach something nutritious for my baby is a big thing to me . â¤ ï¸
O O O O O O O O O O B-Medication O O O O	@USER he's been ok'd my his doc to take baby Benadryl ... Just saying .
O O B-Medication O O O O O O O O O O O	Blonde , Botox , boobs . Fat cunt will love her . # CelebrityBigBrother
O O O B-Medication I-Medication O O O O O O O O O O O O O O O O O O O O O O O O	I take a baby aspirin every night before bed , for my # FactorVLeiden , and I throw it back up every morning # fvl # pregnancyproblems # conundrum
O O B-Medication O	@USER @USER sudafed .
O O O O O O B-Medication I-Medication O O O O O O	Soo about to see how this castor oil works ğŸ˜‚ come on Mason .
O O O O O O B-Medication O O O O O O O O O O O O O O O O O O O O O O	They say if you take a Benadryl it'll knock you and your baby out , only my child will be in my belly having a dollar party still ğŸ™„
O B-Medication O O O O O O O O O O O O O O O O O O O O O O O O O O O	My zofran pump is my biggest insecurity right now , but it saved mine & my babies life . That usually helps me ignore the stares ğŸ’• # hyperemesis
O O O O O O O O O O O O O O O O O O O O O O O O O O O B-Medication	Laying in from of the TV listening to the campfire channel on TV . My Saturday nights have become so tame . # PJs # water # Gaviscon
B-Medication O O O O O	Tums are my new best friend
O O O O O O O O O B-Medication O O O O O O	Heartburn woke me up at 4:30 am . C'mon Gaviscon , do your thing ! !
O O O O O O O O O O O O O O O O O O O O O O O O B-Medication I-Medication O O O	A horrible migraine kept me from working a full day at work . Also , half my department has the flu . Hopefully my flu shot works ! !
O O O O O O B-Medication O O O O O	I liked a @USER video URL Lupron self injection .. Yikes !
O O O O O B-Medication O O O	@USER awwe mane where that epidural at ğŸ˜© ğŸ˜©
O O O O O O O O O O O O O O O O B-Medication O O O O O O O O O O O O O O O O	@USER best advice you can ever get , drink a gallon of water and take a Tylenol before you go out love ! ! Lol happy early bday ğŸ» ğŸº ğŸ» ğŸº ğŸ»
O O O O O O O O O O O O O O B-Medication O O O O O O O O O O O O	@USER It's an old one & absolutely absurd . Type 1 diabetics go on insulin to save their lives . They don't magically develop DM from GMO
O O O O O O O O O O B-Medication O O O O O O O O O O O	Jesus Christ how did I let myself run out of painkillers ? ? Fuuuuuuuck I can barely move out of bed !
O O O O O O O O O O B-Medication I-Medication O O O O O O O O O	I can't type properly tonight ! Too much TV and flu medication ... I'm going back to my sofa home .
O O O O O O B-Medication O O O O O O O O O O O O O	The only thing I hate about IUD are the cramps ğŸ’† ğŸ» like wtf I feel like imma die sometimes
O O O O O O O O O O O O O O O O O O B-Medication O O O O O	I don't get it all the other doctors said she was good so I'm not giving her stupid steroids it's gonna make her overweight
O O O O O O O O O B-Medication O	Pregnancy Accomplishments ? Finished off a large bottle of Tums .
O O O O O O B-Medication O O O O O O O O O O O O	@USER I sucked back so much entonox over the labour I had a massive hangover the next day .
B-Medication O O O O	tylenol is gay af .
O O O O O O O O O O O O O O O B-Medication O O O O O O O O O O O O O	@USER how was I supposed to know ? It's one full bottle and a few pills in the other . Gotta find them . You can have them .
O O B-Medication O O O O O O B-Medication O O	@USER well nitrous .. those college boys did straight nitrous.oh lord .
O O O O O O O O O O O O O O O O B-Medication O O O O	@USER the burn is real . I am having a hard time breathing . Need my Tums to kick in ğŸ˜–
O O O O O O O O O O B-Medication O O O O O O O	@USER Aww , thanks for the encouragement ! You took antibiotics and it took care of it ?
O O O O O O O O O O O O O O O O O O O O O B-Medication O	And dnt be mad cause my relaxer look bomb and i got a head full of hair ... eat u some prenatals ...
O O O O O O B-Medication O O	Keep tellin ppl ian getting da epidural . Lol
O O O O O O O O B-Medication O O O O O O O O	@USER I'm totes fine - just need a Tylenol and to teach my dog some compassion ğŸ˜‚
O B-Medication O O O O O O	@USER epidural is for quitters . lol .
O O O B-Medication O O O O O O O O O O O O O O O O O O O O O O	@USER yep . Antibiotics & prayers that it passes & doesn't spread to my other ear since I took all of my vacation time already .
O O O O O O O O B-Medication O O O O O O O O O O O O O O O O O O	Not sure if I should ask for my epidural already or not ... I'm so scared of how much pain it's gonna be ! ! ! ğŸ˜”
O O O O B-Medication O O O O O O O O O O O O O O O O O O O O	@USER I used the entonox for hours . Sucked back two portable tanks . Couple hours post birth . Massive headache and eye pain .
O O O O O O O O O B-Medication O O O O O O O O O O O	@USER I took the ' Canadian version ' of Unisom and thankfully slept decently with just the regular bathroom breaks haha
O O O O O O O O O O O O O O O O O O O B-Medication O O	Told me to make friends with other real housewives of Brentwood so we could talk about rich husbands and Botox ğŸ˜­ ğŸ˜‚
O O O O B-Medication O O O O O O B-Medication O O O O O O O O O	@USER you can try vitamins for Olivia ! Hudson has taken vitamins since the NICU & it helps him gain weight
O O O O O O O B-Medication O	@USER ğŸ¤” you must have got an epidural ?
O O O O O O O O O O O O O O O O O B-Medication O O	My little Ains is under the weather . She is has viral tonsillitis . They don't give antibiotics â€¦ URL
O O O O O O O O B-Medication O O O O	@USER Braylon and yep with the help of epidural keeping the pain away
O O O B-Medication O O O O O O O O O O O O O O O O O	@USER I'm allowed gravol for nights I can't get to sleep . Not as strong as good stuff but something ?
O O O O O O B-Medication O O O O O O O O O O O O O O O O O O O O	If anyone tells you that the epidural won't make your back hurt . THEM HOES ARE LYING . My lower back has been in pain since .
O B-Medication I-Medication I-Medication O O O O O O O O O O	my birth control patch has made my tits huge as fuq ğŸ™ # thankyou
O O O O O O O O O O O B-Medication O O O O O O O O O O O O O O O O	@USER Hey ! He is sleep ... still has a Lil anesthesia ... but had 2 bottles of Pedialyte and hasn't thrown up ... might be home today
O O O O B-Medication I-Medication O O O O O O O O O O O O O O O O O O O O O O	Off to get my flu shot at work today , want to get a head start at building my immunity to protect me and baby ! # getyourflushot
O O O O B-Medication O O O O O O O O O O O O O O	Yeah im allergic to codiene * idunno if I spelled that right * I learned that the hard way
B-Medication I-Medication O O O O O O O O O O O O O O O O O O	Steroid injections sting like a trooper ! ! I don't mind needles but frig me the liquid hurts ! !
O O O O O O B-Medication I-Medication I-Medication O O O O O O O O O O O O O O O O O O O O O O O	â€œ @USER : U got a birth control shot so u wouldn't get pregnant . Now you fat and look pregnant from the side effects . â€ ğŸ˜‚ ğŸ˜‚ ğŸ˜‚ LOL !
O O O B-Medication	I need some tums
O O O O O O O O O O O O O B-Medication O O O O O O O O	Me & baby are sick ğŸ˜” I have strep throat & I'm taking Tylenol for fever ... ğŸ˜¢ Pray for us ğŸ’”
O O O O O O O O O O O O O O B-Medication O O O O O O O O O	@USER I got asked if I tried ginger ... I'm on 8 pills of diclectin a day ... yeah , I've tried everything !
O O O O O O O O O O O O O O O O O B-Medication O O O O O B-Medication O O O O O O	@USER oh nooo ! ! Do you take anything for it ? I have to take 150mg Zantac twice a day & drink gaviscon extra strength whenever I need ..
O O O O O B-Medication O O O O O O O O O O O O O O	Hudson is FINALLY off his antibiotics & his IV drip ğŸ‘ ğŸ¼ ğŸ™Œ ğŸ¼ one step closer to coming home
O O O O O B-Medication O O O O O O O O O O O O O O O O	@USER they might give you steroids to help her lungs & another medication that will stop contractions , that usually works !
O B-Medication I-Medication O O O O O O O O O O O O O O O O O	The caffeine pills have finally worn off , time to get a half hour nap before James wakes up again
O O B-Medication O O O O O O O O	Imma get Botox so my brows can be snatched like @USER
O O O O O O O O B-Medication O O O O O O O O O O O O	Staying in the hospital tonight.Diagnosed with preeclampsia.Was given shotsto make her lungs grow faster , and hoping she stays baking longer
O O O O O O O O O O O O O O O O B-Medication O O O O O O O O O O O O O O	I'm all like babe I love you but stay the fuck away from me * throws Tylenol & wet rag from across room * & sleep on the couch tonight ğŸ™ƒ
O O B-Medication I-Medication O O O O O	These new prenatal vitamins make me sick . ğŸ˜–
O O O O O O O O O O O O O O O O O O B-Medication I-Medication O O O O	â€œ @USER : Women who pretend to like football are the same women who pretend to be on birth control . â€ ğŸ˜‚ ğŸ˜‚
O O O O B-Medication O O O O O O O O O O O O O O O O O O O O O O O	My diet consists of adderall for breakfast , beer for dinner , & cake pops for bed time snack . So I should be skinny again soon .
O O O O O O O O O O O O O O B-Medication O O O O O O O O O O O	Maintaining my most minimal level of regular activity is becoming so hard ğŸ˜­ + tylenol / naps no longer fix everything . Just sore foreverrrrr ğŸ˜µ
O O O O O O O O O O O O B-Medication O O B-Medication O O O O O O	@USER God knows I need that . Will need to check my prenatal & daily multivitamin to see if I need more
O B-Medication I-Medication O O O O O	these prenatal vitamins got me feeling sick ):
O O O O O O O O O O B-Medication O O O O O O O O O O O O O O O	Like you know how I'm extra cause I don't need Botox cause I don't have wrinkles but I got it to stop them in case lmao
O O O O O O O O B-Medication O O O O O O O O O O O O O O O O O	I wanna have my son natural w no epidural . that back pain it leave you w unt unt I already had back problems before him
O O O O O O O B-Medication O O O O O O O O O O O	The fact that i didn't take my pill by accident lastnight and im insanely sick today .. # woops
O O O O O O O O O B-Medication I-Medication O O O O O O O	I swear I think I'm the only person who's prenatal pills makes them feel sick af ! !
O O O O O O O O O O O O O O O O B-Medication I-Medication O O O O O O O O O O O O O O	Told Jordan to bring me Tylenol & a phenergen & just realized he gave me two Tylenol pm .. its only 2 and I got no sleep last night . Not good
O O O O O O O O O O B-Medication I-Medication O O	And all because I said she couldn't have her brothers epilepsy meds ! URL
O O O O O O O O O O B-Medication O O O O O O O O O O O O O O	Cannot understand how a nurse accepts and approves of GMO insulin for diabetics , but says GMO crops are poisonous ? # facepalm # lostthebattle
O O O O O O O O B-Medication O O O O O O O	@USER thanks , I'm 16wks & still taking diclectin ... so eventually I'll feel wonderful :)
O O O O O O O B-Medication O O O O O	I sleep next to a bottle of tums . # fuckheartburn # kissmyASS
O O O O O O O O O O O O O O O O O O O B-Medication I-Medication O O O O O O O O	# HeadDesk of the day , courtesy of the # RiteAid website . You better run a deal on headache meds , RiteAid . You owe me . URL
O O O O O B-Medication O O O O O	Y'all can give me more Ambien if y'all like . ğŸ˜‚
O O O O B-Medication O O O O O O O O O O O O O	Ended up getting an epidural and I feel great . Time to try to get some sleep .
O B-Medication I-Medication O O O O O O O O O O	my pain meds don't even work for me anymore ): this sucks .
O O O O O B-Medication O	Thank god , hallelujah for percocet .
O O O O O O O O B-Medication O O O O O O O O O O O O O O O O	Once I have my son I'm getting the nexplanon because it has no side effects I do t want to get fat like other people
O O O O O O O O O O O O O O O O O O O O O O O O B-Medication O	Sorry I just slammed that energy drink , fetus . This house HAS to get clean & because of you they took away my adderall .
O B-Medication I-Medication I-Medication O O O O O O O O O O O O O O	@USER VitaFusion prenatal gummies w / all the flavors is literally so delicious , I could overdose ğŸ˜…
O O O O O O B-Medication I-Medication O O O O O O O O O O O O O O O O O O	I'm still amazed how fast that castor oil worked ... I literally took it at 11:30 pm and my water broke at 4:30 am ğŸ™Œ ğŸ¾
O O O O O O O O B-Medication O O O O O O O B-Medication O O	Holy heartburn ! Already took a dose of Tums and still raging ! Send help & antacids ! !
O O O O O O B-Medication O O O	Stephanie sounds like she needs some decongestant ! # RAW
O O O O O O O O O O O O O B-Medication O O O O O O O O O O O O	@USER I am burping him a few times through feed . Just put infacol on my asda delivery . Thanks for reminding me about it !
O O O O O O O O O O O O O O O O O O O O O O B-Medication O O O	So ill with flu / cold symptoms I can barely lift my head ! Anyone know of any preggo-friendly remedies ( besides paracetamol ) ? ğŸ˜°
O O O O O O O O O O O O O O O O O B-Medication	@USER he said I was dehydrated which could cause the cramping so I got some fluids and antibiotics
O O O O O O B-Medication O O B-Medication I-Medication O	@USER did you have the actual shot or the nasal spray ?
O O O O O B-Medication I-Medication O O O O O O O O O O O O O O O O O	The FACT I drunk this castor oil shit twice don't make no fucking sense ... I wouldn't wish that on my worst enemy ğŸ˜·
O O O O B-Medication O O	High af off the morphine ... lol
O O O O O O O O O O O O O O O O O O B-Medication O O O O	I hate that I had to get a C section because now my back kills me from the epidural I had to get
O O O O O O O O O O O O O O O O O O B-Medication O	@USER That's what I'm nervous about , bc I sleep so damn much ! Did you get an epidural ?
O O O O B-Medication O O O O O O O O O O O	But I got my IUD just in case lmfao Rosie's going to be an only child
O O O O B-Medication I-Medication O O O O O O O O O O O	Has anyone gotten the depo shot ? If so , what's your opinion on it ? ğŸ¤”
O O B-Medication I-Medication O O O O O O O O O O O O O O O O O O O O O	My 4th Rhogam shot hurt just as bad as my 1st one . O negative blood is a blessing & a curse . # crybaby
O O O O O O B-Medication O O O O O O O O O O O O O O O O O	@USER She is currently on a morphine drip & hospice is taking over . trying to just make her comfortable at this point .
O O O O O O O O O B-Medication I-Medication O O O O O O O O O O O O O O O O O O	However , if I paired the wine with some muscle relaxers , I might have a greater understanding of what it's like to be Rush Limbaugh ... # Hmmm
O O O O O O O O O O O O O O O O O O O B-Medication I-Medication O O	Just started on my second venti iced coffee from # Starbucks . Drowsiness is INDEED a side effect of muscle relaxers ! =(
O O O O O O O O B-Medication O O O O O O O O O O O O O O O O	# ad Are you good about taking # vitamins ? # HealthYourself and try out a supplement recommender to find your best bets ! URL
B-Medication I-Medication O O O O O	Birth control âœ” ï¸ Prenatal âœ” ï¸
O O B-Medication I-Medication O O O O O O O O O O O O O O O O O O B-Medication I-Medication O O O O O	When your birth control alarm goes off & wakes the baby that just fell asleep ... it reminds you why you take birth control in the 1st place .
O O O O O O O O O O O O O O B-Medication I-Medication O O O O O O O O O O	I really need to pack a bag for Tulsa this weekend but taking a muscle relaxer and passing out in this recliner sounds soooooooo much better
O O O O O O O O O O O O O O O O O O O O O O O O B-Medication I-Medication	Thank god it was just a false alarm I don't want to get pregnant any time soon I'm so scared to stop taking my birth control
O O O O O B-Medication O O O O O O O O O O O O O O O O O O O O O O	@USER Well I was on magnesium . They did labs on me every 4 hours just to make sure I didnt have a lot of it â€¦ URL
O O O O O B-Medication I-Medication O O O O O O O O O O O O O O O O O O O O O O O	I fucking hate how these pain meds make me feel but I'm too sore to function if I don't take them ğŸ˜­ I just want to feel normal again .
O O O O O O O O O O O O O O O O O O O O O O O O O O B-Medication O O O O	@USER hopefully I can shake most of it off today , if not , it's not the end of the world . I can only take Tylenol though ! boo !
O O O O O O O O O O O O O O O O O O O O B-Medication O O O O O O O O O	Also , I think my husband is trying to romance me as he came home with a NEW flavour of Tums that I haven't yet tried . ;) # pregnancy
O O O O O B-Medication O O O O O O O O O O O O O O O O O O O	You won't start feeling the pictocin for about an hour Uh bullshit I've been having contractions since that shit hit my system ğŸ˜¶ ğŸ˜¶ ğŸ˜¶
O O O O O O O O O O B-Medication I-Medication O O O O O O O O	@USER the AC can dry you out . Get a saline spray . Helps keep it from super drying .
O O O O O O O O O O O O O B-Medication O O O O	Just kidding .. more lab work , more doctor visits , and more antibiotics through my veins ğŸ˜¥
O B-Medication O O O O O O O O O O O O O	@USER Tylenol is great for throat pain.The nurse in me goes to drugs first ;)
O O O O O O O B-Medication I-Medication O O O O O O O O O O O O O	@USER Try generic ( Wal-Mart brand ) Prilosec OTC gel capsules . It's the ONLY thing that has helped with my pregnancy
O O O O O O B-Medication O	@USER regardless I'm getting the damn epidural ğŸ’…
O O B-Medication O O O O O O O O O O O O O O	Last min oxys so i can sleep ... juju knocked ... and rell at home cleaning lol
O O O O O O O O O O O O O O O O O O O O O O O O O O B-Medication O	@USER Ugh . I had a sinus infection last Winter and could not get over the teeth pain . So annoying . I ended up on antibiotics .
O O O O O B-Medication O O O O O O O O O O O O O O O O	Getting ' upgraded ' from Tums to a daily OTC . Too bad tomorrow is Christmas Eve so stores will be nuts
O O O O O O O O O O O O O O O B-Medication I-Medication	Last time I had a sore arm from a vaccine was when I got my meningitis vaccine
O O O O B-Medication O	Shoulda took some more NyQuil ğŸ˜”
O O O O O O O O O B-Medication O O O O O O O O O O O O O	Evan & I went into Target to buy some vitamins . We came out with $ 150 + worth of stuff . ğŸ˜…
O O O O O O B-Medication I-Medication O O O O O O O O O O O O	@USER honestly I'm high on American flu medication so I don't even know my own name right now ! ğŸ˜‚
B-Medication I-Medication I-Medication O O O O O O O O O	Nasal flu vac for children .. anyones kids get side effects ?
O O O O O O B-Medication O O O O O O O O O O O O O O O O O O O	So explain to me how GMO insulin is poison ? Without it , diabetics die . Citations for poisoning people and the planet please . @USER
O O O O O O B-Medication O O O	They still want to give her steroids like no foh
O O O O B-Medication O	@USER she had a epidural ?
O O O O O O O O O O O O O O O O O O O B-Medication O O O O	I'm working on it ! 4:00 am now . Pain was intense so I just had a magical wonderful epidural from the â€¦ URL
O O O O B-Medication O O O O O O O O O O O O O O O O O O O O O O O	@USER I didn't take prenatals at all , people didn't back in the day so I don't think it's necessary . Just eat healthy & drink water ğŸ˜Š
O O O O O O O O O O B-Medication I-Medication O O O O O O O O O O O O O O O O O O	My friend asked me where she can go to get birth control and I was telling Jay about it and he goes God you sound like a mom ğŸ˜‚ ğŸ˜‚
O O O O O O O O O O B-Medication I-Medication O O	Feeling great even after giving birth to Jayce without any pain meds . :)
O B-Medication O O O O O O O O O O O O O O O O O	This morphine don't work ğŸ™„ I've pressed this button like 4 times & I still feel like shit ğŸ˜­
O O B-Medication I-Medication O O	Why are prenatal vitamins pricey ?
B-Medication I-Medication I-Medication O O O O O O O O O O O O O O O O O	Tylenol + Codeine ALWAYS makes me feel so weird but it's the only thing that helps my migraines ğŸ˜ ğŸ˜©
O O O O O O O O B-Medication O O O O O O O O	For now after this baby I'm getting the nexplanon for 6 years 3 then another 3 lol
O O O O O O O O O O O O O B-Medication O O O O	I don't wanna take medicine so im just going to try to take emergen-c and hope it helps
O O O O O O O O O O O O O O B-Medication O O O O O O O	I told Michelle Obama I haven't eaten anything in 3 days because I have adderall now . She high fived me .
O O O O B-Medication I-Medication O O O O O O O O O O O O O O O O B-Medication O O O O	Just took my first muscle relaxer to help with my back pain . I don't see what all the fuss is about painkillers , I sdfbyese 5i6tygfdshbve4eui
O B-Medication I-Medication O O	these pain meds suck lol
O O O B-Medication I-Medication	I need some Pepto Bismol
O O B-Medication O B-Medication O O O O O O O O	Is it Tylenol or ibuprofen that you can take while pregnant ? ğŸ¤”
O O O O O O O B-Medication O O O O O O O O O O O O O O O O O O O O O O O	My kids are so envious of the Tums that I chomp on regularly . They cry and beg to have one . Ridiculous . They think I'm chowing candies ? !
O O O O O O O O O O O O O O O O O B-Medication O B-Medication O O O O	@USER I just shouldn't have said anything ... the advise she pours in ğŸ˜‰ I just want Sudafed and NyQuil dammit ! ! !
O O O B-Medication I-Medication O O O O O	Why does my prenatal vitamin smell like dogs medicine lol
O O O O O O O O O O O O O O O O O O O O O O	@USER yeah irking he need his ass whoop I really don't feel good I swear I'm about to go to the hospital
O O O O	Panda Express ğŸ¼ ğŸ˜›
O O O O O O O O O O O O O O O O O O O O O O O	Well .. technology wins agains . People are fighting for an increase in minimum wage , meanwhile the jobs they are ... URL
O O O O O O	@USER what happened ? ? ?
O O O O O O O O O O O O O O O O O O O O O O O	A first grade teacher asked her class to complete the following proverbs . I think some are better then the originals . URL
O O O O O O O O O O O O	I can't wait to have a forever with someone . â˜º ï¸
O O O O O O O O O O O O O O O O O O O O O O O O O O O O O O	My advice to these young ppl running round wanting to get pregnant is ... WAIT ... Go to school , get a house , etc . be financially ready !
O O O O O O	Why he gotta grow up ?
O O O O O O O O O O O O O O O O O O O O O O O O	@USER I'm not , first time I've watched it . They were selling sausage rolls at one point too . Wtf ? Ahaha .
O O O O O O O O	ğŸ˜‚ ğŸ˜‚ ğŸ˜‚ # loveyouJonStewart # jonvoyage URL
O O O O	@USER text me NOW
O O O O O O O O O O	You gotta just hope for the best you know .
O O O O	Omg ğŸ˜ ğŸ˜ URL
O O O O O O O O	Wish I had friends that lived here ...
O O O O O O O O O O O O O O O O O O O O O O	@USER @USER 2009 : clementine , accordion 2011 : swell , light 2013 : river , wolf 2016 : warm , still
O O O O O O O O O O O O O	' 136 days until my baby boy is here ğŸ˜© ğŸ˜­ ğŸ˜ ğŸ˜‡
O O O O O O O O O O O O O O O O O O O O O	McCoy bangs his head on his crib because he thinks it'll get him out of going to sleep .. ğŸ™„ ğŸ˜‚
O O O O O O O O O O O O O O O O	@USER that's what I'm starting to think . People on social media are so weird ğŸ˜©
O O O O O O O	Most Guys Are Dawgs , Fr !
O O O O O O O O	this is literally my dream jeep . URL
O O O O O O O O O O O O O	I know I be playing a lot but I'm serious this time ğŸ˜‚
O O O O O O O O O O	Heading out for a sunny Saturday morning brunch ! !
O O O O O	im just so moody rn
O O O O O O O O O O O O O O O O O O O O O O O O O O	You're going to have 3 days of detention Chance : I probably won't go You'll have ISD then Chance : I'll move schools ğŸ˜‚ ğŸ˜‚ ğŸ˜‚
O O O O O O O O O O	Totally cute picture of my sister and I . URL
O O	ğŸ–• ğŸ»
O O O O O O O O O O O O O O O O O O	My newborn has slept basically all day and so far all night ... This can't be normal ğŸ˜³
O O O O O O O O O O O O O O O O O O O O O O O O O O O O	Decided that enough time had passed since everyone else saw it and loved it and now @USER and I can be cool and give Bojack Horseman a shot
O O O O O O O O O O O O O O O O O O O O O O O O	So now I'm wearing glasses and the eye doctor said it was all because of my pregnancy . LIKE WAIT WHAT ? ? ?
O O O O O O O O O O O O O	my next car will be my 4th car and i'm only 18 lol
O O O O O O O O	I â¤ ï¸ dat romantic shit ğŸ˜ ğŸ˜
O O O O O O	@USER makes me wonder too .
O O O O O O O O O O O O O O O	We ain't spoke in so long , you probably put me in the past .
O O O O O O O O O O O O O O O O O O O O O O O O O O O	Clean air ! ! We had to leave Utah to get it but it was worth it ! # saltlakecity # inversion # asthma # evangelinedelaney URL
O O O O O O O O O O O O O	My mom askin me if i wanna leave to the states ? !
O O O O O O O O O O	Valentines Day With The Twin ğŸ˜ ğŸ’• ğŸ’Œ ğŸ’‹ @USER
O O O O O O O O O O	Today has been cancelled ... Go back to bed .
O O O O O O O O O O O O O O O	@USER I don't think this could describe me any better . ğŸ˜ ğŸ˜‚ ğŸ™„ URL
O O O O O O O O O O O O O O O	I need a friend that like to do stuff damn WTF & ain't broke ğŸ˜«
O O O O O O O O O	Because I decided to be the bigger person .
O O O O O O O O O O O O O O	I remember when family was everything but in reality it was never anything .
O O O O O O O O O O O O O O	@USER ğŸ˜‚ yes but shid you going to get over it sooner or later
O O O O O O O O O O O O O O O O O	I can never nap ğŸ˜« I swear I just wanna sleep all day it never happens !
O O O O O O O	I'm so lucky ğŸ˜» ğŸ˜» ğŸ˜» URL
O O O O O O O O O O O O O O O O O O O O O O O O O	Coconut water + fresh fruit = delicious , ice cream substitute , right ? I'm so ready for spring / summer weather and ... URL
O O O O O O O	This pic is just for @USER URL
O O	@USER ğŸ˜¥
O O O O O O O O O O O	I feel like a stuffed sausage busting at the seams ğŸ˜…
O O O O O O O O O O O O O O O O O O O O O O O	@USER At the very top of the Eiffel Tower in Paris , even the ring box was the Eiffel Tower # propose URL
O O O O O O O O O O O O O O O O O O O O O O	I want Shay and keira to come by me so we can have a movie night . I miss my best friends
O O O O O O O O O O O O O O O O O O O	It turned from falling in love with him , to falling in love with the idea of love .
O O O O O O O O O O O O O O O O O O O O O	Here's To A Day All About Jaz Getting Everything She Needs For Her Arrival . Just Me & & Her ..
O	Yessssssssssssir
O O O O O O O O O O O O O O O O O	# Excited to try the Organic Fiji line from # healthdesigns ! Yay ! - Abby URL
O O O O O	I choose you â¤ ï¸
O O O O O O O O O O O O O	I had to let her know cause if I wasn't pregnant ğŸ˜© ğŸ‘Š
O O O O O	Mmmm whole nut chocolate ğŸ‘Œ
O O O O O	Please just let me sleep
O O	@USER ugh
O O O O O	Good morning world ! â˜€
O O O O O O O O O O O O O O O O O O O O O O O O O O	@USER my sad truth is that I feel the most proud of myself when I shower AND blow dry my hair . I'm not kidding ...
O O O O O O O O O O O O O O	I think I might write a book on mine & & Darriens relationship lol
O O O O	I miss my bf
O O O O O O O O	# 1601 sling b baby wrap ! URL
O O O O O O O O O O O O O O O O O O O	It Shouldn't Be Too Much Longer Before Jaz'Alynn Makes Her Way â˜º ï¸ â˜º ï¸ â˜º ï¸ ğŸ˜Š ğŸ‘
O O O O O O O O O	Waste of my time being at this place .
O O O O O O	Finna get cute bitch what ğŸ˜
O O O O O O O O	My head hurts & my friends are lagging
O O O O O O O O O O O O O O O O O O O	Currently transferring money from my savings into my checking account because I'm so broke . ğŸ˜© ğŸ˜­ ğŸ˜© ğŸ˜­
O O O O O	Today can just screw off
O O O O	@USER ayyyyyyyyyy ğŸ˜ ğŸ˜
O	URL
O O O O O O O	@USER you made my day . ğŸ˜Š
O O O O O O	Jefferson hospital is so fucking slow
O O O O O O O O O	Corrine and Angela gotta get up outta there ...
O O O O O O O O O O O O O O	@USER Ahhhh I LOVE yours ! You rock those bangs better than anyone !
O O O O O O O O O O O	# weddinghour @USER your stationery looked beautiful in the shoot .
O O	RT URL
O O O O O O O O O O O O	I'll text other ppl just to keep my mind off yu ğŸ˜”
O O O O O O O O O O O O	@USER what do YOU know about that is be real question ğŸ¤”
O O O O	@USER â¤ â¤ URL
O O O O O O O O O O O	@USER @USER im crying . The most ridiculous convo ever .
O O O O O O O O O O O O O O	yesss ! ! ! ğŸ˜ ğŸ˜ ğŸ˜ â¤ ï¸ â¤ ï¸ â¤ ï¸ URL
O O O O O O O O O O O O O O O O O O	@USER ğŸ˜¬ ğŸ˜¬ ğŸ˜¬ thanks I thought I was the only one who watch that show ğŸ˜‚ ğŸ˜­
O O O O O O O O O O O	Spontaneous day trip to Auburn ! # chevvyandrons # wareagle URL
O O O O O O O O O O O O O O	@USER my plan is sleep , eat , sleep , eat . ğŸ‘ ğŸ¼
O O O O O O O O O O	Todays . Going . By . So . Slow .
O O O O O O O O O O O	All my own hair bro , all my own hair .
O O O O O O O O	Was hopin to see you again ğŸ˜” ğŸ˜
O O O O O O O O	@USER @USER You are very welcome ! :)
O O O O	I think im hungry
O O O O O O O O O O O O O O O O O O O	nothing is worse than when you look in your drawer for a snack and realize you already ate it
O O O O O O O O O O O O O O O O O O O O O O O O	@USER I'm going to see you on my due date so you'll likely be singing at my baby's birth ğŸ‘ ğŸ‘ ğŸ‘ # nevermindweddings
O O O	Fuck you URL
O O O O O O O	I'm hungry but I'm not hungry ğŸ™„
O O O O	@USER My Belly ğŸ˜‹
O O O O O O O O O	â€œ @USER : She's the real MVP URL â€
O O O O O O O O O O O O O O O O O O O O O O O O O O O O O O	don't come at my friends with the I love you bullshit when you wanted no part of them & they wanted all of you , it's too late for that
O O O	@USER xoxoxoxo !
O O O O O O O O O O O	Is this week over yet or no ... ğŸ˜¥ ğŸ˜­ ğŸ˜ª
O O O O O O O O O O O O O O O	Next time you try to touch me with something cold when I'm sleeping @USER URL
O O O O O O O O O O O	@USER take it somewhere to get it done then ğŸ’ ğŸ¼
O O O O O O O O O	I wish I could smoke , but I can't
O O O O O O O O O O O	I can't wait to leave next month âœˆ ï¸ ğŸ™Œ ğŸ½
O O O O O O O O O O O O O O O O O O O O O O O O O O O O	I've always wondered how some ppl can just walk around musty .. Do u not smell ya self , I can smell ya from a distance ğŸ˜– ğŸ˜–
O O O O O O O O O O O O O O O O O O O O O O O O	Dropped my keys in the only hole that's on our porch , which means once again I'm locked out my car and house ğŸ˜‘
O O O O O O O O O O	That's money I could buy things for my child with
O O O O O O O O O O O O O O O O O O	Today on the Gilmore Girls : Keiko Agena ( Lane ) did an AMA on reddit ! URL
O O O O O O O O O O O O O O O O O O O O O O O	I've been @USER a lot lately and I like it . One of the most relaxing parts of my week . # PrenatalMassage
O O O O O O O O	I posted a new photo to Facebook URL
O O O O O O O O	the taste of salt on my lips ..
O O O O O O O O O O O O O O O O O O O O O O O O O O O O	@USER My best friend passed away in a car crash and I want to take her sister in law to see Lana please help . ğŸ™ â¤ ï¸
O O O O O	Happy New Year . URL
O O O O O O O O O O O O O	â€œ @USER : you bitches fraud a lot ğŸ˜© âœŒ ï¸ ğŸ˜‚ â€
O O O O O O O O O O O O O O O	This double denim look is currently on URL ( link in bio ) â€¦ URL
O O O O O O O O	@USER I am SO excited for # CelebrityMasterChef
O O O O O O O O O O O O O O O O O O O O O O O O O O O	Honestly I just love my little makeup collection . I'm not a makeup artist , but it's so fun to have and play with . ğŸ’• ğŸ€
O O O O O O	Ky on tv . # dontbotherme
O O O O O O O O	I have to work in the morning .
O O O O O	@USER DUHHH lol â˜º ï¸
O O O O O O O O O O O O O O O O O O O O O O O O	Pissing myself at how pathetic phoebe is in next weeks episode ! .. The more I watch the more I LOVE @USER # teamlucy
O O O O O O O O O O O O O O O O O O O O O O O O O O O	I'm almost done with the nursery ! ! I just need to clean the carpet , add some curtains and a few photos for the ... URL
O O O O O O O O O	Who wants dogged on this lovely day ? ?
O O O O O O O O O O O O O O O O O O O O O O O O O O O O O O O	A lot of pregnant young girls won't admit that it is hard , being pregnant isn't fun . If you don't have help you will struggle . Wait ğŸ’¯ ğŸ’¯ ğŸ’¯
O O O O O O O O O O	Pretty women and a whole bag of goldfish # whoops
O O O O O O O O O O O O O O O O O O O O O O O O O O O O	Doctors appointment tomorrow ğŸ˜† Hopefully I'm dilated somewhat and my doctor can tell me when he thinks she will come ğŸ™ ğŸ¼ ğŸ’Ÿ Ready for my baby ğŸ˜©
O O O O O O O O O O O O O O O O O O O O O O O O O	Justin and I are thrilled to announce the birth of our sweet , healthy , and beautiful baby girl - Joy Belle ! ... URL
O O O	<3 URL URL
O O O	Heyyyyy ğŸ’— URL
O O O O O O O O O O O O O O O O O O O	The jack of all trades is seldom exceptional at anything , and usually broke as well . - Unknown
O O O O O O O O O O	one person followed me / / automatically checked by URL
O O O O O O O O O O O O	I lost my homies .. ğŸ’” I can't feel a thing .
O O O O O O O O O O O O O O O O O O O	Not only do I need Jayden in my life , He needs me in his life as well .
O O O O O O O O O O O O O O O O O	i cant believe this was taken with a phone , i neeed the 7 ğŸ˜­ ğŸ˜­ URL
O O O O O O O O O O O O O O O O O O O O O O O O	@USER Matheus funciona assim , se o pedido for retornando , nÃ£o podemos fazer a devoluÃ§Ã£o atÃ© a mercadoria estiver em nossas mÃ£os !
O O O O O O O O O O O O O O O O O O O O O O O O O O O O	my whole life I've never even bought perfume because I know it could cause him to die . Did he not grow up in the same house ?
O O O O O O O O O O	Shit that used to phase me just doesn't any more
O O O O	@USER no just @USER
O O O O O O O O O O O O O O O O O O O	You are being pushed and pulled all over the map now ; you migh ... More for Libra URL
O O O O O O	@USER You're so stupid I swear
O O O O O O O O O	@USER oh god should I be worried ? ğŸ˜‚
O O O O O O O O O O O O O O O O O	My tummy sits so low , , that's how I kinda knew it was a boy ...
O O O O O O O	Can't sleep , but what's new ?
O O O O	i hate wack ppl
O O O O O O O O O O O O O O O	I hate when I come home and my shit not how I left it ..
O O O O O O O O O	Worrying about a coyote breaking into my house URL
O O O O O O O O O O O O O O O O O O O O O O O O	The power couple is headed to Austin ! Dreams do become reality , but only when you stop dreaming and starting doing ! URL
O O O O O O O O O O O O O O O O O O O O O O O O O O O O O O O O	@USER @USER I was almost gonna just keep scrolling but this is a damn shame ğŸ˜’ y'all need to not be hoes . Do . Not . Be . A . Ho
O O O O O O O O O O O O O O O O O O O O O O	This Ramadan was my first to fast while being pregnant in my third trimester . I was a little hesitant â€¦ URL
O O O O O O O O O O O O O O O O O O O O O O O O O O O O O O O	Wooden floor has been delivered so it can ' adapt to our temperature ' ... I find this really weird but Alex says it's just ' what you do ' .
O O O O O O O O O O O O O O O O O O O O O O O	Feel like crying my baby polo has been attacked by an Alsatian and is at the emergency vets sedated in critical condition ğŸ˜­
O O O O O O O O O O O O O O O	My dad mistaked the GIRLS bathroom for the men's .. Lol wrong bathroom dude ğŸ˜‚
O O O O	my mood got killed
O O O O O O O O O O O O O O O	What did you expect , for me just to wait around and look stupid .
O O O O O O O O O O O O O O O	â¤ ï¸ # feelinglonely # miss # love # husband # wife # lover URL
O O O O O O O O O O	You can't please everybody , even if you try .
O O O O O O O O O O O O O O O O O	You may assume there is safety in numbers today , prompting you ... More for Virgo URL
O O O O	@USER love you ğŸ˜˜
O O O O O O O O O O O O O O O O O	Baby bump making an appearance at our gender reveal party ... follow me on snapchat â€¦ URL
O O O O O O O O O O O O O	When y'all mad at each other but you still miss him ğŸ˜© ğŸ˜‚
O O O O O O O O O	Somewhere On A Beach x Dierks Bentley lol basically
O O O O O O O O O O O O O O O O O O O O O	Going from work to fun in my labelbylegoe pants . The stretchy waist makes them so comfy with my â€¦ URL
O O O O O O O O O O O O O O O O O O O O O	@USER I know ! ! ! I'm gonna be cuddled up with Nova and hot chocolate watching 25 days of Christmas
O	URL
O O O O O O O O O O O O O O O O O O O O O O O O O O O O	Hendrix hates being touched when he eats ğŸ¼ he mugs & makes little grumbling noises if you touch him while eating ğŸ˜‚ I need to record it lol
O O O O O O	@USER @USER Thank you babe ğŸ¤—
O O O O O O O O O	That bitch tired to get the best of me
O O O	The explorers URL
O O O O O O O O O O	@USER @USER @USER qua Niyah gotta get hers REGARDLESS ğŸ˜‚
O O O O O O O O O	@USER Thank you ! I'm so very pregnant !
O O O O O O O O	Well that's straight coincidence ... weird . ğŸ˜’
O O O O O O O O O O O O O O O O O O O O	Power was so good this week ğŸ™Œ ğŸ¾ ğŸ™Œ ğŸ¾ ğŸ™Œ ğŸ¾ I'm so happy lol ğŸ˜‚ ğŸ˜‚ ğŸ˜‚ ğŸ˜©
O O O O O O	They need to be slapped URL
O O O O O O O O O O O O O O O O O O O O O O O O	I tell myself you're getting in too deep then I fall a little farther ... Every time you look at me â˜º ï¸ ğŸ‘«
O O O O O O O O O O O O O O O O O O O O	@USER idk who ur going in on , but you just kept me entertained til I got off work .
O O	@USER URL
O O O O O O O O O O O O O O O O O O O O O O O O O O	how did you lose so much weight and how long did it ... â€” Change of diet and going to the gym . A year URL
O O O O	@USER @USER absolutely beautiful
O O O O O O O O O O O O O O O O O O O O O O O O O O O	This lady keeps talking to me in Spanish and I keep saying yes . She's probs said I'm going to kill you and I just agreed ğŸ™‚
O O O O O O O O O O O O O O O O O O O O O	He always got them fucking excuses ... I pray to the lord you reveal what his truth is ğŸ™„ ğŸ‘ ğŸ½
O O O O O O O O O O O O	Can't sleep when my son keeps givin hard kicks to the ribs
O O O O O O	But anyways ğŸ˜‚ ğŸ˜‚ âœŒ ï¸
O O O O O O O O O O O	I just finished cleaning and boiiii I'm tired ğŸ™‚ ğŸ™‚ ğŸ™‚
O O O O O O O O O O O O O O O	I think its too early to be threatening bitches , so imma wait until noon
O O O O O O O	Daddy , tigger & woof ! URL
O O O O O O O	take yo ass to hibernation smh URL
O O O O O O O	Man I been eatin every 20 Minutes
O O O O O O O O O O O O	I hope I eat some yummy cakes tomorrow # birthdaygirl # preggers
O O O O O O O	@USER I love you â¤ ï¸ URL
O O O O O O O O O O O O O O O O O	Trying to get my homework done while he watches this game , please don't talk to me
O O O O O O O O O O O O	@USER nooooooo ğŸ˜« if you really are send me your number babe
O O O O O O O O O	I'm only leaving my house to get cake ğŸ˜‚
O O O O O O O O O O O O O O O O O O O O O O	Saw a guy walking in the airport wearing a @USER shirt and sweating profusely . Don't preworkout and fly . # traveltips
O O O O O O O O	what do I keep crying for ğŸ˜’ ğŸ˜­
O O O O O O O O O O O O O O O O O O O O O O O O O O O O	Jesus Christ do I look bloody rough this morning . Crap sleep awake since 4ish feel as rough as I look . Concealer coming out to play today
O O O O O O O O	Why tf my hands swelling up ? ğŸ˜’
O O O O O O O O O O O O O O O	That ain't a mouth full or Oreo cookies ... it's dirt . # NeverTurnYourBackOnAToddler URL
O O O O O O O O O O O O O O O O O O O O O O O O O O O O O O O	@USER do what you think is best , but I'm sure you will be a great mother . Don't let the stress get to you . It will get better .
O O O O O O O O O O O O O O O O O O O O O O O O O O O	@USER Thank you for the updates , Neopets ! It's been SO GOOD to actually get these updates throughout all this , and has boosted morale !
O O O O O O O O O O O O O	@USER basically ğŸ˜’ it's only free if they are like 2 and under
O O O O O O O	What's Alex Cooking For Me This Morning
O O O O O O	I drank too much coffee URL
O O O O O O O O O O O O O O O O	This kiddo is AWAKE and MOVING after 11 days of being paralyzed . So â€¦ URL
O	ğŸ’¤
O O O O O O O	@USER Thank you ! ğŸ˜­ ğŸ˜­ ğŸ˜­
O O O O O O O O O O O O O O O O O O O O O O O O	well since you asked .. respecting our moms & ourselves , not embarrassing our parents on national tv . not being ratc â€¦ URL
O O O O O O O O O O O O O	Tomorrow's another day and I'm thirsty anyway so bring on the rain ..
O O O O O O O O	Looking for a prom dress is stressful .
O O O O O O O	@USER okay by where Jacob live ?
O O O O	Ew ! # hollyoakslater
O O O O O O O O O O O	@USER LOVE your collection , what brand is your favorite ?
O O O O O O O O O O O O O O O O O O O O O O O	I want to see the new star wars movie it will be sold out at every theater when it comes out # StarWarsTheForceAwakens
O O O O O O O O O O O O O O	@USER Sai hoje , sobre o instagram e problemas de bloqueo de contas .
O O O O O O	Fuck the government . # stupidchildren
O O O O O	I straight got the flu
O O O O O O O O	Getting baby shower ready for actualash . URL
O O O O O O O O O O O O O	My whole body hurts I just want to go home and rest ğŸ˜«
O O O O O O O O O O O O O O O	@USER your right but just delete the app go on when your bored maybe .
O O O O O O O O O	I haven't been depressed since like middle school .
O O O O O O O O O O O O O O O O	@USER are you fucking kidding . ? No you are not . ! ğŸ˜³ ğŸ–• ğŸ»
O O O O O O O O O O O O O O	had no idea baby shower cards would cost a arm and a leg ğŸ™„
O O O O O O O O O	Whenever I start to click with someone they leave
O O O O O O O O O O O O O O	Bc moline on February is too soon . Nova will only be three months
O O O O O O O O O O	Someone bring me an ice cream cookie sandwich ! ğŸ˜©
O	URL
O O O O O O O O O O O O O O O	@USER dang it's still going to be high I have a I phone 6 plus
O O O O O O O O O O O O O O O O O O O O O	@USER Yay ! :D Glad you got your Echo items ! Looking forward for your reviews , thanks for sharing !
O O O O O O O O O O O O O O O O O O O O	@USER @USER Good to hear . I'm going to see it Friday ... was hoping for some solid laughs .
O O O O O O O O O O O O O O O O O O O O O O O O O O O O O O	i have completely gone off the # PostCircle track - life has been manic . want to get back into it though ... are you all still doing it ?
O O O O O O O O	hello from me and my Amaru ğŸ’ URL
O O O O O O O O O O O O O O	29 weeks pregnant ! ! # twinpregnancy # twinbelly # twinboys # blessed URL
O O O O	Hate mondays # rollontheweekend
O O O O O O O O O O	I'm such a happy person when I'm with my brothers
O O O O O O O O O O O O O O O O O O O O O	always want someone by my side when im going through some shit but i always end up going through it alone
O O O O O O O O O	I wish I would've never updated snap chat ğŸ™„
O O O O	ğŸ˜‚ ğŸ˜‚ fr URL
O O O O O O O O O O O	@USER how much Vitamin D3 should a toddler be getting ?
O O O	RT ! URL
O O O O O O O O O O O O O O	I dnt have friends I have girlfriends â¤ ï¸ that title much better ğŸ’
O O O O O O O O O O O O O	SINCE WHEN HAS THE NEW BLUE MOUNTAIN STATE MOVIE BEEN ON NETFLIX OMG
O O O O O O O O O O O O O O O O O O O O O O O O O O O O O O O	My baby never lets me sleep and makes me sick 24/7 so Austin started yelling at my belly saying you are so bad ! you're a bad girl ! ğŸ˜‚ ğŸ˜­
O O O O O O O O O O O O O O O O O O O	i have so many baby clothes i can't wait for mia to be here ğŸ’– 5 weeks to go
O O O O O O O O O O O O O O O O O O O O O O O O O O O O O O	ORRR they don't run those yellow lights that i know we could have made . ğŸ˜‚ drive too slow . just lil shit . but it annoys me . ğŸ™„
O O O O O O O O O O O O O O	Attempt two at making dinner . Let's hope this goes well . # wishfulthinking
O O O O O O	Whoo-hoooo 25 weeks ! ! URL
O O O O O O O O O	I can't let this cold keep me down ğŸ˜·
O O O O O O O O O	@USER I love you . I miss you .
O O O O O O O O O O O O O	# NowPlaying Alive With The Glory Of Love by Say Anything â™« URL
O O O	@USER ğŸ‘Œ ğŸ¼
O O O O O O O O O O O O O O O O O O O O	Can I just live in the bathtub ? Nothing hurts , & it's always nice & & warm . ğŸ˜ª
O O O	@USER ohh okay
O O O O O O O O O O O O	@USER YES ! I award myself 5 movie points ! # Dance
O O O O O	Smiling from ear 2ear ;)
O O O O O O O O O O O O O O O	Nicki & I at the mall right now is a shit show ... # toostressedforlife
O O O O O O O O O O O O O O O O O O O	â€œ @USER : O god I do start school in a week .. ğŸ˜³ â€ Me Too ğŸ˜Š ğŸ‘
O O O O O O O O O O O O O O O O O O O O O O O O O O O	We got a better look at the baby boy yesterday during a follow up ultrasound . We've never had a 3D image done of an â€¦ URL
O O O O O O O O O O O O O O O O O O O O O O O O O O O	I was excited that T passed out so I could make an anniversary cake and then realized I need 3 eggs and only have 2 . URL
O O O O O O O O O O O O O O O O O O O O O	All black today on URL ( link in bio ) â¬› ï¸ â—¾ ï¸ â–ª ï¸ / / liketoknow.it â€¦ URL
O O O O O O O O O O O	ion talk much but i say a lot . ğŸ‘Œ ğŸ¼
O O O O O O O	@USER should come see us more ğŸ˜‹
O O O O O O O O O O O O O O O O O O	Looking for a place to getaway from all of the heart aching pains that life can bring .
O O O O O	aw thanks bby ğŸ˜˜ URL
O O O O O O O O O O O O O O O O O O O O O	Went to take my finger out of brixon's hand & he squeezed it even tighter .. I needed that so much
O O O O O O O O O O O O O	I hate when I can't sleep & dusty just passes out . ğŸ™„
O O O O O O O O O O O O O O O O O O O O	@USER I think that'd be so cool ! :) you'd be birthday twins with my babyyy â˜º ï¸ â˜º ï¸
O O O O O O O O O O O O O	Will and i just argued over roast potatoes . Pathetic . Hahah .
O O O O O O O O O O O O O O O O O O O O O O O O	We took the kids to a mega playdate with Nick Jr . and got some great ideas for preschool activities ! URL # sponsored
O O O O O O O O O O O O O O O O O O O O O O O O O O O	I always wanted to be out of philadelphia , a college graduate , and married when I had children ... God had other plans for me ğŸ’™
O O O O O O O O O O O O O O O	You Are Left 2013 , No Room In 2014 For Your Dirty Dog Ass .
O O O O O	@USER ğŸ˜‚ ğŸ˜‚ ğŸ˜‚ asshole
O O O O O O	@USER I want to see it
O O O O O O O O O O O O O O O O O O O O O O O O O O O	@USER Beau is ok . I think we are getting somewhere slowly . Me and Will are fine , just tired . Thanks for the thoughts x
O O O O O O O O O O O O O O O O O	If you aren't getting rejected on a daily basis , then your goals aren't ambitious enough .
O O O	@USER ğŸ˜‚ ğŸ¤˜
O O O O O	Cant wajt for saturday .
O O O O O O O O O O O O O O O O O O O O O O O	This girl on Maury thinks her dude is cheatin ad bringing the girl to her house so she leaves the girl notes ...
O O O O O O O	Shit just not the same nomore ğŸ˜”
O O O O O O O O	Birthday dinner w / my main â¤ ï¸
O O O O O O O O O O O O O O O O	I almost forgot I had a doctor appt in the morning ğŸ˜’ I'm so over this
O O O O O O O O O O	Awe hell now Joey pregnant ! ! Mimi say goodbye
O O O O O O O O O O O O O O O O O O O O O O O O O O O	Kyrie having a fit because I won't let him sleep up under me ... Like the ac not working it's too hot for all that ğŸ˜© ğŸ˜©
O O O O O O	@USER URL there ya go .
O O O O O O O O O O O O O O O O O	@USER @USER when is the draw ? Do you have to be here to win ? ğŸ’™
O O O O O O O O O O O O O O O O O O	When I play bachata on my belly Elyza kicks around . ğŸ˜ probably the coolest experience ever .
O	URL
O O O O O	I know wat to do
O O O O O O O O O O O O O O O O O O O	Haven't even clocked into work and ready to go ğŸ˜’ im not even in the mood to talk .
O O O O O O O O O O O O O O O	@USER really ? I thought about applying there if I move back to the area
O O O O O O O O O O O O O O O O O	How to decorate a village hall on the blog URL # hextable # villagehall # styledbynaomi URL
O O O	@USER yes ğŸ˜Œ
O O O O O	@USER come to my casa
O O O O O O O O O O O	I'm trynna figure out what clup you talking about ğŸ™„ URL
O O O O O O O O O O O O O O O O O O O O O	Hi @USER hope it's not too late ! ! ! Talking ADD with ADD - Misconceptions ( # MHW2K16 ) URL
O O O O O O O O	Today is National Feel The Love Day ğŸ’•
O O O O O O O	A lot Dying young .. smh ğŸ’”
O O O O O O O O O O O O O O	@USER I'm pretty disappointed to discover you discontinued your Hot Mustard ... # bringitback
O O O O O O O O O	I Wish Someone Could Bring Me Some Fries ğŸŸ
O O O O	ğŸ˜¹ ğŸ˜¹ ğŸ˜¹ URL
O O O O	@USER hahahahaha ğŸ˜‰ ğŸ˜‚
O O O O	hOney ğŸ‘… ğŸ’• URL
O O O O O O	Canton will forever be trash URL
O O O O O O	I been gone all morning .
O O O O O	Lol shit crazy doe ğŸ˜´
O O O O O O O O O O O O O O O O O O	Why do writers make up words ? Why not use a dictionary ? WELL ... # AWP16 URL
O O O O O O O O O O O	The bath tub and heating pad are my best friends .
O O O O O O	What happen to ice jj fish
O O O O O O	@USER happy bday ğŸ˜˜ â˜º ï¸
O O O O O O	Marcus Hughes working hard :-) URL
O O O O O O O O O O O O O	@USER the party at @USER when shit got toooo real ! ? !
O O O O O O O O O	im eating garlic bread and drinking lemonade # PregnancyProblems
O O O O O O O O O O O O O O O	some of the things yall say about white people is just rude and annoying lol
O O O O	I'm just so tired
O O O O O O O O O O O O O O O O	@USER you were in my dream and in my dream I asked about your cat ğŸ˜‚
O O O O O O O O O O O O	Nails & feet done âœ” ï¸ baby shower tomorrow â˜º ï¸ URL
O O O O O O O O O O O O O O O O O O O O	12 days left of April then it'll be May , then the countdown really begins . June 22nd ğŸ‘¶ ğŸ½
O O O O O O O O O O O O O O O O O O O O O	@USER @USER Yay ! Happy to see you got your Echo items ! Anxious to see what you think ! :)
O O O O	@USER Please email social@healthdesigns.com
O O O O O O O O O O O O O O O O O O	all i know is bg mbsc ... i don't know what niggas got going on period ğŸ–• ğŸ½
O O O O O O O O O O O O O O O O O O O O O O O	It's not even Halloween and I have everyone's Christmas presents picked out already , except for @USER she ain't getting shit . ğŸ˜‚
O O O O O O O O	The struggle is real at @USER . URL
O O O O O O O O O O O O	I'm gonna be so sad not seeing Draya every Monday # BBWLA
O O	Heartburn ğŸ˜©
O O O O O O O O O O O O O O O O O O	Or think that pregnancy has caused me to say eff my appearance and whoever don't like it lol
O O O O O O O O O O O O O	2:30 pm -7:30 am My Work Schedule For Today ğŸ˜ ğŸ’° ğŸ˜ ğŸ’°
O O O O O O O O O O	The good ones go if you wait too long ğŸ™ƒ
O O O O O O O O	We have finals tomorrow y'all better study .
O O O O O O O O O O O O O O O O O O O O O O O	@USER my favourite shop ! Would love love love to win this for summer ! # IMPRESSYOURSELF # competition # win â€¦ URL
O O O O O O O O O O O O O O O O O O O O O O O O O O O O	Second Saturday in a row I've baked a cake . Last weekend was golden cake w / vanilla buttercream . Today , fudge marble w / chocolate buttercream
O O O O O O O O O O O O O O O O	Others see you as a positive force now with confident Jupiter ... More for Libra URL
O O O O O O O O O O O O O	ï¸ï¸Hahaha brightens up my day as usual . ğŸ™ˆ ğŸ˜ ğŸ‘¯ ğŸ’ URL
O O O O O O O	So ready to go home and sleep
O O O O O O O O O O O O O O O O O	When you miss someone but there's no way you can speak too them # sad # missyou
O O O O O O O O	These emotions are way too much for me
O O O O O O O O O O O O O O O O O O O O O O O O O O O O O	It is a horrible comparison ğŸ˜­ ğŸ˜­ ğŸ˜‚ ğŸ˜‚ but please just po ... â€” no free toe pics sorry , if u want it ur paying lol URL
O O O O O O O O O O O O O O O O O	@USER We are going to the Jays game tomorrow afternoon too . Should be a fun day
O O O O O O O O O O O O O O O O O O O O O O O O	never get attached to anything . attachment is the root of all suffering . non attachment is the way of life . ğŸ’œ URL
O O O O O O O	I have zero energy today ğŸ˜­ ğŸ˜­
O O O O O O O O O O O O O O	Anytime Austin tries to kiss or touch Jayde , she starts growling ğŸ˜‚ ğŸ˜­
O O O O O O O O O O O O O O O O O O O O O O O O O O O	@USER he telling to fuck yu up so now wassup ! Yu know where I live in I know where yu live so what yu wanna do
O O O O O	@USER Vinton la why baby
O O O O O O O O O O O O O O O O O O O O O O O O O O O O O O O O	Can a woman be a Champion , or is she a Championette ? Championtress ? I know a feminists answer would be ' a woman can be whatever she wants ! '
O O O O O O O O O O O O	I love watching cats bathe themselves . It's so friggin cute .
O O O O O O O O O O O O O O O	I'll put money in my ppl pocket before I give it to a stranger ...
O O O O O O O O O O O	man it's the worse when ur whole body just feels sad
O O O O O O O O O	@USER ğŸ™Œ ğŸ¼ ğŸ™Œ ğŸ¼ ğŸ™Œ ğŸ¼ ğŸ™Œ ğŸ¼
O O O O O	@USER omg which one lmao
O O O O O O O	@USER he is SO sh * t
O O O	@USER Kay ğŸ’•
O O O O O O O O O	That dream was so lit .. no lie ğŸ˜†
O O O O O O O O O O O O O O O O O O O O O O O O O O O O O O O O	S'funny how Katie always calls me when shes going in on someone . I help , I'm like yea ill drop kick her throat in half with my pinky toe ğŸ‘Š ğŸ¼
O O O O O O O	Bitch wanna be brittnii so bad lol
O O O O O O O O O O O	â€œ @USER : When the beat drops ... URL â€ @USER
O O O O O O O O O O O O O	@USER could you cut out the bit of cardboard box it's in ?
O O O O O O O O	Look who's getting some makeup ! ! !
O O O O O O O O O O O O O O O O O O O O O O O O O O O	Whoohoo ! 100 of you love us enough to admire us on @USER ! We're soaking up the love , friends ! Xo > > â€¦ URL
O O O O O O O O O O O O O	I really hope she get my boots â˜º ï¸ ğŸ˜ ğŸ˜ # Jordan
O O O O O O O O O O	@USER DipBrow in Ebony and Modern renaissance Palette ğŸ˜‹ URL
O O O O O O O O O O O O O O O O O O	Sebastian John Hammond Morton , born 04-10- 14 at 17:39 . 7lbs14 of amazingness . # newborn URL
O O O O O O O O O O O O	Slept through the night for the first time in a long time
O O O O O	Playing catch up ! URL
O O O O O O O O O O O O O O O O	This is what happens when you don't sleep ladies and gentlemen . ğŸ‘ ğŸ¼ ğŸ‘ ğŸ¼
O O O O O O O O O O	@USER Grammys are tomorrow not Oscars ! I've see 3
O O O O O O O O O O O O O O O O O O O O O O O O O O O	THANKS FOR ALL THE ADVICE . I'M PREGNANT AND YOU'RE CLEARLY A TRAINED MIDWIFE OR DOCTOR . I APPRECIATE YOU THINKING SO I DON'T HAVE TO .
O O O O O O O	@USER @USER Ray stop stealing people's phones
O O O O O O	@USER thanks Liya ğŸ˜˜ ğŸ˜˜ ğŸ˜˜
O O O O O O O O O O O O O O O O	Gotta get back on my shit , looking for a two bedroom apt ... ğŸ•µ ğŸ¡
O O O O O O O O O O O O	Anybody know any good places to get a pits ears cut ?
O O O O O	Such a relatable convo URL
O O O O	mama & princess URL
O O O O O O O	@USER You are very welcome ! :D
O O O O O O O O O O	so glad im off i had a long fucking day
O O O O O O O O O O	I hate waking back up from a Deep sleep ğŸ”¨
O O O O O O O O O O O O O	All I do is eat and sleep now smh . I'm so exhausted
O O O	Fake promises .
O O O O O O O O	Literally about to lose my mind today .
O	URL
O O O O O O O O O	WHITE LACE DRESS + AN UPDATE URL on @USER
O O O O O O O O O	My cloth diaper stash is growing ! ! URL
O O O O O O O O O O O O O O O O O O O O	man i wish my mom was still alive so bad i'm in need of a full time friend / supporter
O O O O O O O O O O O O	@USER yes . That's npr . 88.5 is our NPR station .
O O	Schoooool ğŸ“š
O O O O O O O O O O O O O	My bae a be so mad but it's so ğŸ’¯ ğŸ˜‚ ğŸ˜‚ URL
O O O O O O O O	Homiee needs to get to the house .
O O O O O O O O O O O O O O O O O O O O O	He cool is as butter to these females . Lets see if that tone changes when scrappys on the scene ;)
O O O O O O O O O O O O O O O O O O	How about Baked Lemon Pepper Chicken & Rice for an easy , delicious and healthy dinner â€¦ URL
O O O O O O O O O O O O O O	# chillpill # dead ğŸ˜‚ ğŸ˜‚ ğŸ˜‚ # HealthDesigns # doitforthevine # YOUKNOWYOULOVEUS URL
O O O O O O	I had a change of heart
O O O O O O O O O O O O O O O O O	I hate hospitals . I don't want to be here for 9 weeks ğŸ˜– ğŸ˜ ğŸ˜£ URL
O O O O O O O O	Today chill night with them ğŸ’• â¤ ï¸
O O O O O O O O O O	1st school picture was a sucess ! # preschool URL
O O O O O O O O O O O O	Because I was messing around and ended up like it . URL
O O O O O O O O O O O O O O O O O O O O O	I think Greg and I have bought pretty much everything we need for life with a baby ! ğŸ™‰ ğŸ‘¶ ğŸ’™
O O O O O O O O O O O O O O O O O O O O	to everyone doing something fun , at a concert or on vacation , on the beach ... i hate u
O O O O O O O O O O O O O O O O O O O O O O	get pissed off everytime i think about this shit . bitches is trifling & give no fucks ! shit is disgusting .
O O O	my shit URL
O O O O O O O O	Why can't isis just leave us alone damn
O O O O O O O O O O O O O O O O O O O O O O O O	@USER have you heard of Purple Aki ? I'm just watching about him now . I thought it was a joke at first !
O	URL
O O O	Merry f'n Christmas
O O O O O O O O O O O O	@USER I'm off Monday yippeeee hope your off too ! ! Xx
O O O O O O O O O O O O O O	my dad literally mixes a whole bunch of food together & calls it breakfast
O O O O O O O	@USER Yay I Won't Feel Fat !
O O O O O	Don't need problems right now
O O O O O O O O O O O O O O O O O O O O O O	Multiple photoshoot options for my maternity shoot , gosh I can't wait until I have my baby to do regular shoots .
O O O O O	I painted Adelyn's toes ğŸ™Š
O O O	Rt . URL
O O	Awwwww Zoe
O O O O O O O O O O O O O O O O	And sing on the top of your lungs because that song speaks to your soul .
O O O	# Frohead URL
O O O O O O O O O O O O O O O O O O O O O O O	i literally write down any advice you give i look u ... â€” omg that is so sweet thank u â¤ ï¸ URL
O O O O O O O O O O O O O O O O O O	â€œ @USER : Finna go to my new school â€ Have A Good Day ! â˜º ï¸ ğŸ˜˜
O O O O O O O O O O O O O O O O O	are you ever gonna come back â€” to visit maybe , and for my baby shower URL
O O O O	@USER I'm uncomfortable .
O O O O O O O O O O O O O O O O O O O O O O O O O O O O O O	My dad wakes me up for the dumbest shit ever sometimes , he'll be like I need help & it'll be to help him find something on his phone ğŸ˜‘
O O O	# NewProfilePic URL
O O O O O O O O	I need a outfit for tonight ğŸ™ƒ ğŸ™ƒ
O O O O O O O O O O O O O O O	@USER @USER @USER Glad you guys like it . Cats ! Who knew ? =)
O O O O O O O O O O O O O O O	@USER showing off our Lolita Cameos & Bird Skull Plugs ! Available at URL URL
O O O O	It's Half Priced ..
O O O O O O O O O O	I seriously have no appetite and I hate it .
O O O O O O O O O O O	I have mega itchy feet ! ! ğŸ’¢ ğŸ’¥ ğŸ”¥ ğŸ‘£
O O O O O O O	I called him head doctor ğŸ˜ ğŸ˜
O O O O O O O O O O	But I think I just gotta fall back ğŸ˜” ğŸ˜’
O O O O O O O O O O O O O O O O O O O O O O O O	city link seem to think i have unlimited hours to wait and money to keep calling . feel my pregnancy hormones , shitbags .
O O O O O O O O O O O O O O O O O O O O O O	I'm trying so hard not to curse my grandma ass tf out ... She need to take her ass home bruh fr
O O O O O O O O O O O O	These socks with aloe are my life right now . So comfy
O O O O O O O O O O O O O O O O O O O O	Pearl Party Launch ! Those opening first are : Kerry Robinson Chloe Jones Kate Caffell Claire Williams Sonia ... URL
O O O O O O O O O	@USER @USER including pregnant ladies having problems sleeping ?
O O O O	@USER thank you ğŸ˜˜
O O O O O O O O	BOLD AF ğŸ˜‚ ğŸ˜‚ ğŸ˜‚ im dying URL
O O O O O O O O O	I'm in bed comfortable and I'm hungry like WHY
O O O O O O	living in a daze . ğŸ˜
O O O O	exactly ! ! URL
O O O O O O O O	Somebody come rub my scalp . â˜º ï¸
O O O O O O O O O O O O O O O O O O O O O O O	I am so thankful that I only have to experience summer through the first half of my pregnancy . These Texas ... URL
O O O O O O O O O O O O O O O O O O	@USER it's from a guy who posted it on a sale site on Facebook Gainsborough Market Street group
O O O O O O O O O O	I'm 23 weeks and 2 days ğŸ’š â¤ ğŸ‘¶ ğŸ¾
O O O	âš“ ï¸ URL
O O O O O O O O O O O O	It needs to be 4:30 already so Brock can be home ..
O O O O O O O O O O O O O O O O O O O O O O O O O	@USER @USER only thing he gives your ratchet ass is black eyes . So how bout your shit your damn mouth and quit actin hard
O O O O O O O	@USER how far along are you ?
O O O O O O O O O O O O O O	How rude ! And I am pretty sure we are still here ;-) URL
O O O O O O O O O O O O O O	I'm pregnant and almost went into labor watching this ğŸ™ƒ ğŸ™ƒ ğŸ™ƒ thanks URL
O O O O	@USER ğŸ˜œ ğŸ‘¸ ğŸ½
O O O O O O O O	I posted a new photo to Facebook URL
O O O O	@USER @USER @USER URL
O O O O O O O O	My moms making my favorite dish tonight ğŸ˜Š
O O O O O O O	@USER ğŸ‘ ğŸ¼ ğŸ‘ ğŸ¼ ğŸ‘ ğŸ¼
O O O O O O O O O O O O	' but I ended up eating del taco ğŸ˜‹ ğŸ˜ # PregnancyProblems
O O O O O O O O	Once i lose feeling they don't come back
O O O O	Yes ğŸ˜ ğŸ˜© URL
O O	@USER @USER
O O O O O	I have to ğŸ™„ URL
O O O O O O O O O O	Social media : who knows Texts : lil bit URL
O O O O O O O O O O O O O O O O O O O O O O O O O O O	Nay gets a new Barbie . Takes al of her clothes off of her because it's bedtime and let's daddy know that barbies name is Suga ...
O O O O	@USER love youu ğŸ˜š
O O O O O O O O O O O O O O O O O	Final grades posted and I only got one A . Hahahaha ... ğŸ˜­ ğŸ˜­ ğŸ˜­ # Blife
O O O O O O O O O O O O O O	It's too late to make it right and I probably wouldn't if I could
O O O O O O O O O O O O	I always feel super adult when I get an oil change .
O O O O O O O O O	Go Back To The Spot Tonight , Well Damn
O O O O O O O O O O O O O O O O O O O O O O O O O O O O O O O	Kade makes me so happy he's really doing everything and anything for me and our baby girl ğŸ˜­ â£ ï¸ for US for our little family ğŸ‘¨ â€ ğŸ‘© â€ ğŸ‘§
O O O O	@USER disappointed in you
O O O O O O O	I have wants and needs ! !
O O O O O O O O O O O O O O O O O O O O O O O O O O O O O O	Whoever said eating an apple will fill you up ... one of the biggest lies I have ever heard . I'm starving ! Bring on the latte and scone !
O O O O O O O O O O O O O O	When English people say ' mom ' loser it's ' mum ' ! !
O O O O O O O O O	Tonight we celebrate our amazing day with burritos .
O O O O O	This bitch got 23 carots
O O O O O O O O O O O O O O O O	... watch who you call your friend . this is bs . so sad . URL
O O O O O O O O O	whos the ugliest person you know â€” U URL
O O O O O O O O O O O	Sabel is so protective over me I swear ğŸ˜­ â¤ â¤
O O O O O O O O	Yay got the job . ğŸ˜„ ğŸ‘ ğŸ™Š
O O O O O O O O O O O O O O O O	This heart burn tho < < < this little boy better come out with hair ğŸ˜£
O O O O O O	@USER thank you ! â¤ ï¸
O O O O O O O O O	Looking for the motivation to learn to drive .
O O O O O O O O O O O O O O O O O O O O O O O O O	Especially when there's crimes in our neighborhoods that needs to be addressed . Senseless crimes need to be stopped all together ( cont . )
O O O O O O O	@USER high ass ğŸ˜‰ ğŸ˜‚ ğŸ˜ ğŸ’¨
O O O O O O	Stripes x Denim # ootd URL
O O O O O O	I want some pineapples now ğŸ˜©
O O O O O O O O O	Man I need a job to support my family
O O O O O O O O	My appointment tomar check on my young ğŸ‘¶
O O O O O O O O O O O	@USER thank you boo ğŸ˜­ ğŸ’• I'll text you rn !
O O O O	going back to sleep
O O O O O O O O O O O O O O O O O	So ready to go back to work I got money to make & things to do ğŸ’¯
O O O O	I'm chillinnnn ğŸ˜ ğŸ˜´
O O O O O O O O O O O O O O O O O	i know im prego and all but laying in bed alone on nye is not the move
O O O O O O O O	I posted a new photo to Facebook URL
O O O O O O O	@USER @USER @USER yuuuummmmmm ! ! !
O O O O O O O O	when you happy shit don't even matter ğŸ™‚
O O O O O	@USER Mhm Bet You Are
O O O O O O O O O O	@USER your only missing foreign films ... totally ok .
O O O O O O O O O O O O O O O O	No way ... She is not that big now ğŸ˜© ğŸ˜© ğŸ˜© oh my god URL
O O O O O O O O O O O O O O O O	Currently on URL ( link in bio ): a fringe sweater and strappy sandals â€¦ URL
O O O O O O O O O O O O O O O O O O O O O O	So , what's the difference between @USER ' s @USER and @USER ? Besides that we STILL WAIT for more Invisbilia .
O O O O O O O O O O O	He always will have a place In my heart â¤ ï¸
O O O O O O O O O O O O O O O O O O O O O O O	The Twins are doing perfectly ! ! Heartbeats at 160 and 164 <3 I will post pics later - Happy Summer Solstice <3
O O O O O O O O O O O O O O O	People don't change . If someone's broken , they just stay broken . # NewGirl
O O O O O O O O O O O O O O O O O O O O O	The question is not why am I awake but why am I awake watching a documentary about Auschwitz . # Questions
O O O O O O O O O O O O O	@USER no , i don't . no-one owned those baby rabbits either !
O O O O O O O O	I can't wait to see my pretty baby
O O O O O O O O O O O O	I GOT MY LEG PICKED UP AND LORD ğŸ˜ ğŸ˜ ğŸ˜ URL
O O O O O O O O O O O O O O O O O O O O O O O O O	Alex Ross predicted this :@ DCComics : Justice League # 12 Superman and Wonder Woman as new power couple . Find out more : URL
O O O O O	@USER we will tomorrow â¤
O O O O O O O O O O O O O O O O O O O O O O O O O O O O	@USER I'll try ğŸ¤” ğŸ˜‚ my fat ass can't even sit in a chair without having shortness of breath ğŸ˜‚ ğŸ˜‚ ğŸ˜‚ everything's about to be a wrap
O O O O O O O O O O O O O O O O O O O O O O O O	It's only 10:30 in the morning but I promise I could probably eat a whole pizza by myself right now . ğŸ• ğŸ• ğŸ•
O O O O O O O O O O O O O O O O O	Post workout snack because my life is all about balance , you guys . # pregnancy URL
O O O O O O O O O O O O O O O O	Texting Someone & & Realizing How Much Youd Love To Steal Them Off One Good Time
O O O O O O O O O O O O O O O O O O O O	Doctor said I could go into labor any time after these next two weeks .. What ğŸ˜³ seems unreal .
O O O O O	@USER JÃ¡ estou chegando lÃ¡
O O O O O O O O O O O O O O O O	It's my birthday ! Thank you God for allowing me another year of life . URL
O O O O O O O	@USER never . Gives me a headache
O O O O O O O O O O O O O O O O O O	ğŸ˜‚ bitches quick to say they bitches but they always talking about they bitches let not ğŸ’¯ ğŸ‘Œ
O O O O O O O	I've always been jealous of Rory Gilmore
O O O O O O O O O O O O O	Tired of being emotional on top of already being a Gemini . ğŸ˜
O O O O O O O O O O O O O O	I just want a massage and to be held and be fed and sleep
O O O O O O O O O O O O	@USER if you cry I'll punch you for being a little bitch
O O O O O	@USER ugh , pants .
O O O O	I blame myself tbh
O O O O O O O O O O O O O O O O O O O O O O O O O O O O O O O O	after a nice day ( had a scan and then went pushchair shopping ! ) i am going to bed with my kindle and a ham & cheese sandwich . WIN !
O O O O O O O O O O O O O O O O O O O O O O O O O O O	Don't ever expect me to praise my mom when you don't know what she's put me through and how she treats me . Seriously fuck off .
O O O O O O O O O O O O O O O O O O O O O O O O O O O O O O	Every time I show grandma a picture of someone she always feels the need to zoom in so far to where you can almost see their pores ğŸ˜‚ ğŸ˜‚ ğŸ˜‚
O O O O O	@USER my exact plan .
O O O O O O O O O O O O O O O O O O O O O O O O O O O O	Sometimes when I can't sleep I reply to texts at random times . I assume if people don't leave their phone on silent it's their own fault .
O O O O O O O O O	i don't know what the fuck he thought ğŸ˜‚
O O O O O O O O O O O O O O O O	Our new Tiger Floral Dangles . Different flowers to choose from ! Available at URL URL
O O O O O O O O O O O O	One that be bout that action , let that banga blow .
O O O O O O O O O O	Never like to start all over wit a new person
O O O O O O O O O O O	@USER whattt ? ! ? ! Don't forget about me !
O O O O O O O O O O O O O O O O O O O O	Shopped at Walmart , Costco and Stater Bros today . Suppose now I should figure out what's for dinner .
O O O O O O O O O	Don't argue with nobody anymore ... # growth ğŸ˜‡
O O O O O O O O O O O O	@USER I just don't understand why my friends are so reckless ğŸ˜‚
O O O O O O O O O O O O O O O O O O O O O O	I've always had a job even worked my whole pregnancy until now . But it's what's best for my baby girl .
O O O O O O	It got sooooo cold ğŸ˜© ğŸ’œ
O O O O O O O O O O O O O	@USER Lol Don't , If He's There Today I'll Sit With Him Lbvs
O O O O O O O O O O O O O O O O O O O O O	Happy Father's Day to my man who I know gone be the best papi or he WILL get shot â˜º ï¸
O O O O O O O O O O O O O O O O O	Lilianna was kicking me all night , crazy I can actually feel her little feet now ğŸ‘£
O O O O O O O O O O O O O O O O O O O O O O O O O O O O O O O O O O O	@USER : * while sleeping * I'm a robot . I have no stomach . Me : What ? * wakes him up * Him : Sorry , I was dreaming about Black Ops .
O O O O O O O O O	Might get the iPhone 6 ğŸ˜³ fingers crossed .
O O O O O O O O O O O O O O O O O O O O O O O O O O O O O O	@USER I couldn't believe it . Not to mention we need to boil water everyday now to make saline ... epic fail . I might need the paste ! !
O O O O O O	@USER Where are you going ?
O O O O O O O O	@USER That's pretty sweet . Good luck !
O O O O O O O O O O	Mall of America . Needs to be a trip .
O O O O O O	Im scared ugh plz dont start
O O O O O O O O O O O O O O O O O O O O O O O	@USER @USER I'm not sure what law this is but on numerous occasions Matt and I have done this at different establishments .
O O O O O O O O O O O O O O	@USER bitch I said I would send u pics and vids of the BABY
O O O O O O	@USER it hurt so bad ğŸ˜­
O O O O O O O O O O O O O O O O O	It's okay baby girl I'm here I gotchu you . Love you so much ğŸ˜ ğŸ’• URL
O O O O O O O O O O	I have no clue what's going on in pll ğŸ˜’
O O O O O O O O O O O O	I need a vacation away from everything just me and nature .
O O O O O O O O O O O O O O O O O O O O O	Shoot me I do not want to get a two hour ultra sound done this early when I barely slept ğŸ˜­
O O O O O O	ğŸ˜­ my feet ! ! URL
O O O O	@USER thank you ğŸ˜˜
O O O O O O	thirty two weeks URL on @USER
O O O O O O O O O O O O O O O O	Fuck it I'm tired of trying to make time for us & i never get it
O O O O O O O O O O	Banks Co already cancelled school for tomorrow ... Tf ?
O O O O	I Want Something Sweet
O O	kinda cba
O O O O O O O O	@USER Those are the best kind â¤ ï¸
O O O O O O O O O O O O O O O O O O O O	You would think the days would fly by with me sleeping until one everyday , but nope . # stilldraggin
O O O O O O O O O O O O O O O O O	Spending so much $ on our car today . It better purr like a kitten now .
O O O	# RAOKearthsbest !
O O O O O O O O O O O O O O O O O O O O	@USER @USER thank you ! My photography and styling was put to the test ! Glad you like it ğŸ’•
O O O O O O O	@USER I Can't Wait ! ! ğŸ˜
O O O O O O O O O O O O O O O O O	Can't remember the last time I actually slept good & didn't wake up throughout the night ğŸ˜–
O O O O O	6 weeks 3 days ğŸ’™
O O O O	so damn sleepy ğŸ˜¿
O O O O O O O O O O O O O O O O O O O O O O O O O O O	It's not going to be pretty when our babysitter @USER wakes up and learns that @USER is no longer coming to Bite of Las Vegas . ğŸ˜¥
O O O O O O O O O	Finished baby shower shopping . I'm so excited !
O O O O	@USER super gross .
O O O O O O O O O O O O O O O O O O O O O O O O O	My favorite part of my Me Day ... most women like to shop for clothes ... I like grocery shopping . It's so ... URL
O O O O O O O O O O O O O O O O	These fucking crack heads n da lou always trying to sing & dance for some shit
O O O O O O O O O O O O O	Ain't no way In hell i can let me friend get beat up
O O O O O O O O O O	one person followed me / / automatically checked by URL
O O O O O O O O O O O O O O O O O	. @USER - I'm not calling you fat but you look a lot bigger . # pregnancy
O O O O O O O O O O O O O O O	Worldwide Advocates in Women's Health Unite to Raise Awareness for Endometriosis - the ... URL
O O O O O	@USER thank you ğŸ˜˜ ğŸ˜˜
O O O O O O O O O O O O O O	@USER ill dog on it until it gets put in the drama category .
O O O O O O O O O O	Pizza and Netflix until baby gets home . â˜º ï¸
O O O O O O O O O O O O O O O O O O	My meeting was canceled and @USER has my lil man till noon . # MeTime ğŸ‘ ğŸ‘ ğŸ‘
O O O O O O O O O O	Aw yay , didn't have any morning sickness today :-)
O O O O O O O	Take me back to Friday .. URL
O O O O O O O	My stomach is not okay rn .
O O O O O O O O	A little Valentine's Day inspiration :) URL URL
O O O O O O O O O O	@USER @USER lmao I love you audrey ! ğŸ˜‚ ğŸ˜‚
O O O O O O O O	@USER ain't shit donor is more like it
O O O O O O O O O O O O O O O O O O O O O	@USER my mother will be there and so will his , so hopefully we won't have to do much talking .
O O O O	@USER hahaha yes !
O O O O	@USER Haha Fr Tho
O	ğŸ’”
O O O O O O O O O O O O	For this child , we have prayed . ğŸ‘¶ ğŸ¼ ğŸ‘£ URL
O O O O O	I feel sick is shit
O O O O O	@USER Why thank u ğŸ˜›
O O O O O O O O O O O O O	@USER no I'm at home very boring , come over if u want
O O O O O O O O O O O O	Omg does McDonald's have their shamrock shakes out ? ! ğŸ˜ ğŸ€
O O O O O O O O O O O O O O O O O O O	i will continue to be amazed at how my bf deals w / my psycho ass ! ! ğŸ˜¬
O O O O O O O O O O O O O	@USER definitely not ! ! It makes me want to puke ! Bleckk
O O O O O	@USER I'm jealous â˜¹ ï¸ï¸
O O O O O O O O O O O O O O	Some Advice after Short Term Disability ( Vlog 8/ 24/16 ): URL via @USER
O O O O O O O O	I can feel my baby moving ! ğŸ’™
O O O O O O O O O O O	damn . my feeling woulda been hurt too haha . URL
O O O O O O O O O O O O O	# NowPlaying What's My Age Again ? by blink - 182 â™« URL
O O O O O O O	she does its so crazy ğŸ˜­ URL
O O O O O O O O O	If funny cuz the bitch tried to be slick
O O O O O O O O O O O O O O O O O O O O O O O O O O O O O	@USER Kevin . I literally thought this was you acting like you were coming out lmao lmao I didn't realize it rhymed and was a rap ğŸ˜‚ ğŸ˜‚ ğŸ˜‚
O O O O O O O O O O O	@USER I really do miss you sm it hurts my heart
O O O O O O	haha & again ğŸ’› @USER URL
O O O O O O O O O O O O O O O O O O O	@USER don't bring up my fucking kid , I ain't the type to fight but I'll fuck you up
O O O O O O O	@USER @USER @USER Muchas gracias â£ ï¸
O O O O O O O O	@USER My nephew would love one of these
O	URL
O O O O O O O O O O O	@USER ğŸ˜© ğŸ˜© ğŸ˜© omg the baby be here In 13days
O O O	Dippin dots ğŸ˜
O O O O O	@USER be careful ğŸ˜˜ ğŸ˜˜
O O O O O O O O O O O O O O O O O O O O O	Effe ! ! ! Didn't want them to tie up this game . Let's go HABS ! ! ! # gohabsgo
O O O O O O O O O O O O O	My phone is full of unsaved numbers .. ğŸ¤· ğŸ½ â€ â™€ ï¸
O O O O O O O O O O O	so glad i got a screen protector on my iPhone ğŸ˜Š
O O O O	ğŸ˜‚ ğŸ˜‚ ğŸ˜‚ URL
O O O O O O O O O O O O O O O O O O O O	It just got serious . 2015 will require some extra sweat equity but my goals will be accomplished ! URL
O O O O O O O O O O O O O O O O O O O O O O O O O O O O	I love holidays . I love weekends in holidays even more . Even more so now I'm a stay-at-home mom cause I celebrate skool holidays too ! ğŸ˜Š
O O O O O O O O O O O O	headache . bad skin . bad hair . this is winter .
O O O O O O O O O O O O O O O O O O O O O O O O O O O O O O O	0hYAH0hhhhYESZ 13 dayz Til # MATANGI drops ! omgsh ğŸ˜ ğŸ˜ ğŸ˜œ ğŸ˜ ğŸ˜ ğŸ˜· ğŸ‘³ ğŸ˜‘ ğŸ™‹ # mia # maya # yala # kala # arular # miauniverse URL
O O O O O O O O O O O O O	It's hard to answer the question what's wrong ? when nothing's right ..
O O O O O O O O O	I AM ABOUT TO GO CRAZY IN THIS HOSPITAL
O O O O O O O O O O O O O O O O O O O O O O O O O	This dude sits in his garage ( with it open ) and plays music while beating the drums it's so annoying and he fucking sucks
O O O O O O O O O O O O O O O O O O O O O O O	This lil boy done knocked on the door and finessed me and my mama outta 20 $ .. he was a sweetheart tho
O O O O O O O O O	Hot chocolate is the best on a cold day
O O O O	My life ğŸ™„ URL
O O O O O O O	I have a picslip up â˜º ï¸
O O O O	@USER i'm gonna cry
O O O	@USER ğŸ˜ ğŸ˜˜
O O O O O O O O O O O O O O O O O O O O O O O O O	Upset I missed the first few mins of love & hip hop . My TL is MADD at these ladies for not havin a ğŸ’
O O O O O O O	4 days until due date ğŸ¤° ğŸ»
O O O O O O O	We used to be inseparable URL URL
O O O O O O O O O O O O O O O O O O O O O	When yr husband wakes up less than 5 minutes after you decide to turn on the light and read : URL
O O O O O O O O O O O O O O O O O	Dead . ğŸ’€ tired of work but I am doing it all for my baby girl .
O O O O	@USER I love you
O O O O O O O O O O O O	In About 6 Weeks My Bugs Will Be Here â˜º ï¸ ğŸ˜Š
O O O O O O O O O O O O O O	Happy birthday , Gracie Lou ! We love you ! # tbt @USER URL
O O O O O O O O O O O O O O O O O O O O O O O O O O O	Words can't express how much this means to me ! When I first met Mr . Thomas Felder in Las Vegas I asked him what ... URL
O O O	@USER ğŸ˜˜ ğŸ˜˜
O O O O O O O O O O	@USER @USER oh I didn't know that was why ...
O O O O O O O O O O O O O O O O O O O	Oooo I hope Dawson hate you ğŸ˜’ ğŸ˜’ ğŸ˜’ âœ‹ hope he pisses all over you ! ! !
O O O O O O O O O	I'm so hungry & Lilly won't stop kicking ğŸ˜¤
O O O O O O O O O O O O O O O O O O O	Kade used to be scared to grab melo and now he picks him up just like nothing ğŸ˜‚ ğŸ’œ
O O O O O O O O O O O O O O O O O O	When you have so much baby shower decorations , you have to get a UHAUL ğŸ™† ğŸ» ğŸ˜‚
O O O O O O O O O	@USER my automobile is a piece of CRAP .
O O O O	@USER @USER ommm ğŸ˜¤
O O O O O O O O O O	I hope that doesn't mean August will be a crybaby
O O O O O O O O O O O O O O O O O O O	A glimpse at what's coming to URL tomorrow ğŸ‘€ P . S . My watch is from â€¦ URL
O O	@USER Waterproof
O O O O O	I'm so annoyed lmao wtf
O O O O	I miss @USER ğŸ˜©
O O O O O O O	When you realize shit was never real
O O O O O O O O	Wanna go home to my babyyyyyy ğŸ˜« ğŸ˜«
O O O O O O O O O O O O O O O O O O O O O O O O O	@USER thanks ! I'll check out those recos ! You're doing an awesome job ! One of each actually ğŸ‘¶ ğŸ½ ğŸ‘¶ ğŸ¼ ğŸ’™ ğŸ’—
O O O O O O O O O O O O O O O	He's a smart man , I must say ğŸ¤˜ ğŸ½ ğŸ˜‚ ğŸ˜‚ ğŸ˜­ ğŸ˜­ URL
O O O O O O O O O O O O O O O O O O O	Nothing stranger then family treat your friends like family but treat certain members of the family like strangers .
O O O O	Yes ğŸ˜© ğŸ˜ URL
O O O O O O O O O O O O O O O O O O	As soon as I get comfortable enough to sleep peacefully . I have to use the bathroom .
O O O O O O O O O O O O O O O O O O O O O O O	falling asleep next to your bestfriend and boyfriend all in one is the most perfect , safest place to be . ğŸ’• URL
O O O O O O O O O O O O O O	on the blog # flowercrown advice URL photo by : @USER # weddingblog URL
O O O O O O O O O	At least my skin looks good i guess URL
O O O O O O O O O O O O O	My phone on 6 % where is my charger I hate this shit
O O O O O O O O O O	29 Weeks Pregnant : Information & Tips - BabyGaga URL
O O	Bruce URL
O O O O O O O O O O O O O O	@USER Oh these sound so lovely ! Would love to win and try them
O O O O O O	Ain't nobody taking my baby ğŸ˜Œ
O O O O O O O O O O	@USER I'm gone hit you when I see you !
O O O O O O O O O O O O O O O O O O O O O O O	Got my issue of Allergic Living today and there's a really good piece about what to do when allergy stress becomes â€¦ URL
O O O	@USER Same ğŸ˜­
O O O O O O	@USER I'll bring yall some peanuts
O O O O O O O O O O O O O O O O O	Working all weekend . Which means movie nights with the family instead of going out . ğŸ˜’
O O O O O O O O O O O O	Exactly 3 years ago today ! ( via @USER ) URL URL
O O O O O O O O O O O O O O O O O O	@USER I hope baby 2 has a big head with big blue eyes just like his brother .
O O O O O O O O	Taco Bell really does sound amazing right now
O O O O O O	This boy . # calvinwilliam URL
O O O O O O	I hate findin shit like this
O O O O O O O O O O O	# Blogged : talking about my vest friend ---> URL URL
O O O O O O O O O O O O O O O O O O O O	â€œ @USER : THERE FOUR BAGELS LOOSE IN MY NEIGHBORHOOD AND I'VE NEVER BEEN HAPPIER URL â€ ğŸ˜‚ ğŸ˜‚ ğŸ˜‚
O O O O O O O O O O O O O O O O O O O O O O O O O O O O O	Ummm stephan needs to get a little crafty , I want him to build the baby a custom book shelf because reading is going to be an everyday thing
O O O O O	@USER & say what ?
O O O O O O O O O O O O O O O O O O O O O O O O O O	Looking up night hikes to go on tonight & getting completely off topic because theres so many cool other places to visit ! * hearteyes *
O O O O O O O O O O O O O O	Happy Birthday to this stud I'm proud to call mine ! xo URL URL
O O O O O O O O O O O O O O O O	I have a billion pics of jaylen I'm about to make him a scrap book .
O O O O O O O O O O O O O O	My boyfriend wants to take my pregnant ass to the sxsw takeover ğŸ˜‚ ğŸ˜©
O O O O O O O O	I posted a new photo to Facebook URL
O O O O O O O O O O O O	@USER aww - he can sing along with this one ! URL
O O O O O O O O O O	Thoughts on face mist's / sprays ? # beautychat URL
O O O O O O	@USER hahaha I know ğŸ˜‚ ğŸ˜‚
O O O O O O O O	freshly picked for baby ! URL on @USER
O O O O O O O O O O	Basically my reaction to Indiana going for Trump ... URL
O O O O O O O O O O O O O O O O O O O O O O O O	@USER lovely ! from what i can gather # teampheasant is currently myself and @USER - i * think * :) thank you :)
O O O O O O O O O O O O O O O O O O O O O O O O	3cm down , 7 to go .. and some terrible contractions to go with it . Hoping for a baby today ! # pleaseandthanks
O O O O	AF ! ! URL
O O O	@USER Pooda ğŸ˜
O O O O O O O	This is why you're my favorite URL
O O O	@USER I'm sleep
O O O O O O O O O	My life's stupid ... And I'm tired of stupidty
O O O O O O O O O O O O O O O O O O O O O O O O O O O O	Cleaned all the bathrooms . But over did the bleach . Pregnancy has made me OCD . Anywho shoulda showered it off . Now the bleach is itchy
O O O O O O O O O O	So glad we are near end of bikini season ğŸ™Œ
O O O	OHIO STATE BABY
O O O O O O O	Hate waking up out my sleep ğŸ˜¤
O O O O O O O O O O O O O O O O O O O O	@USER it's okay . I am just being responsible because I could but I know it's not right . ğŸ‘
O O O O O O	put you first . â¤ ï¸
O O O O O O O O O O O O O O O O O O O	Watching old Family Feud and Richard Dawson just took the stage with no corsage . MADNESS ! # MomLife
O O O O O O O	Lol my mama just be lieing lol
O O O O O O	i miss my gauges :( URL
O O O O O	Macaroni Grill with mom ğŸ€
O O O O O O O	@USER some secret code bullshit . ğŸ˜­
O O O O O O O O O O O O O O O O O O O	I hate having a little sister . She's always taking my shit after I tell her not to .
O O O O O O O O O O O O O O O O O O O O O O O O	Don't forget you have till 2/14 to get 15 % off your entire order when you use the code : VALENTINE at â€¦ URL
O O O O O O O O O O	I'm at 200 Degrees Coffee - @USER in Nottingham URL
O O O O O O O O O O O	Changing my number mfs keep playing on my phone tf !
O O O O O O O O O O O O O O O O O	I'm Sad So What Do I Do , Go Buy A Bunch Of Food .. # TruFatAss
O O O O O O O O O O	My tummy on fire ğŸ˜« ğŸ˜« ğŸ˜« ğŸ˜¢ ğŸ˜¥ ğŸ˜ª
O O O O O O O O O O O O O O O O O O O O O O O O O O O O O	Has anyone else gone through something like this ? I have no idea what to do , I'm so mad and heartbroken that they would act like this .
O O O O O O O O O O O O O O O O O O O O O O O	These statues are apart of history . 10 years ago this didn't even matter . I swear this country is so stupid .
O O O O O O O O O O O O O O O O O O	Here's the thing : I'm not coming to Waffle House at 4 a . m . # overheardintheelevator
O O O O O O O O O O O O O O O O O O O O O	@USER oh I've been there . I feel ya hun . Best of luck . Rooting for ya ! ! !
O	Lol
O O O O O O	@USER @USER What's the topic ?
O O O O O O O O O O O O O O O O O O O O O O O O O	Just downloaded the new @USER album on Apple Music . It will be ready to roll for some Saturday listening . # drake # views
O O O O O O O O O O O O O O O O O O O O O O O O O O	Today on the blog , I'm telling the story of how I realized my great grandparents had lied about being married . I al â€¦ URL
O O O O O O O O O O O O O O O O O O O O O O O O O O O O O O O O	You Can Cry , Let It All Out . But Make Sure Your Eyes Are Wiped & & Nobody Sees You Hurting . People Will Use It To Their Advantages . RS
O O O O O O O O O O O O O O O O O O O O O O O O O O O O O O	I don't know this PK guy because I only 15 % follow hockey , but losing Shea is SO SAD to us 15 - percenters . # RIPNameIKnew # preds
O O O O O O O O O O O O O O O O O O O O O O O	I've been super emotional here lately so Keat cooked me my favorite meal tonight . Love my man more than anything â¤ ï¸
O O O O O O O O O O O O O O	If you get out of Dayton , Ohio then you're making it man .
O O O O O O O O	I am so uncomfortable I can't stand it
O O O O O O O O O	@USER everything's good getting by thanks for asking ğŸ˜˜
O O O O O O O O O	Lady gaga should be interesting next week ! ğŸ’­
O O O O O O O	Mad my videos taking forever to load
O O O O O O O O O O O O O O O O O O	I may be young but I'm readyyyyy . To leave this training but it's all love ğŸµ ğŸ¶
O O O O O O O O O O O O O O O O O O O	I really hope I continue to lose weight with this pregnancy and afterward . I feel so great .
O O O O O O	@USER she loves you too ğŸ˜˜
O O O O O O O O O O O O O O	@USER you bragging a lot lol bout stuff these Lil girls can NOT handle
O O O O O	Maybe you're pregnant ğŸ˜³ URL
O O O O O O O O O O	3 people followed me / / automatically checked by URL
O O O O O O O O O O O	@USER What kind of side effects do the injections cause ?
O O O O O O O O O O O O O O O O O O O	We're different people , live different lives and different friends ... But together we always pick up â€¦ URL
O O O O O O O O O O O O O	@USER I don't suck dick anyways so I wouldn't thank you very much
O O O O O O O	I Miss Cuddling Though , Fr ğŸ˜
O O O O O O	@USER you looking hard af lol
O O O O	Apple pie wasted .
O O O O O O O O O O O O O O O O O O O O O O O	Repost from @USER . Delivery 20 days ! Tax : NO :) Enjoy your new Whey protein . Thank you for â€¦ URL
O O O O	I hate the rain
O O O O O O O O O O	@USER Happy Birthday you ! Have a good'n :) xx
O O O O O O O O O O O O O O O O	Can't wait till have my son so I can dance for my baby ğŸ˜ ğŸ™Š ğŸ’¦
O O O O O O O O O O	Waiting on my new furniture to be delivered . ğŸ˜
O O O O O O O	@USER ahh poo poor baby ! :(
O O O O O O	@USER @USER okay I will ğŸ˜Œ
O O O	@USER ğŸ˜« ğŸ˜«
O O O O O O O O O O O O O O O	@USER she did but she could've saved herself had she not start talking that shit
O O O O O O O O O O O O O O O	@USER @USER JOEY YOU STOPPIT ! I was feelin them abs tho ! ! !
O O O O O O O O O O O O O O O	I'm so weak lmao @USER twerkin by the milk machine back in the day URL
O O O O O O O O O O O O O O O O O O O O O	Just found some new ANIMAL gym bags in our receiving department ! They look super nice and remind me â€¦ URL
O O O O O O O O O O O O O O O O O	if only they knew i carried a taser on my at all time too . ğŸ˜‚ URL
O O O O O O	Having a blast in Durant !
O O O O O O O O O	I gave you that nigga ğŸ’¯ ğŸ‘Œ ğŸ˜‚ ğŸ˜‚
O O O O O O O O O O O O O O O O O O O O	@USER he used to live in our hometown lol , they reconnected over Facebook then started going on skype dates
O O O O O O O O O O O O O O	My baby been comin here since Thursday to help me threw my pain ğŸ˜
O O	Mhmmmmmm .
O O O O O O O O O O O O O O O O O O O O O O O O O O O O O O	Coach has informed me she wants me to come help @USER & & others after the baby is born with 3rd base ! ğŸ˜ ğŸ’• âš¾ ï¸ ğŸ’ª # YouReady
O O O O O O O O O O O	@USER I'll keep it safe for ya , pal ! URL
O O O O O O O O O O O O O O O O O O O O O O O O O O O O	@USER naw I'm good ... Yu telling my business to ya bitch in I'm arguing with her she decides to say some shit . That's female shit ğŸ˜´
O O O O O O O O O O O O O O O O O O O O O O	Happy motherfucking birthday to my real friend , my real lover ! I wouldn't trade u 4 a thing ! @USER URL
O O O O O O O O O O O O O O O	@USER I'm so glad to hear you're getting in ! Have an amaaaaaazing time !
O O O O O O O O O O O O O O O O O O O O O O	@USER @USER you wanna go out tomorrow ? My best friend Geena is in town ! My mom said she'll watch nov
O O O O O O O O O O O O O O O O O	Although you're on the edge of an expansive period in your lif ... More for Libra URL
O O O O O O O O O O O O O O O O O O O O O	I was pregnant in 2013 , 2014 , and 2015 ... I will not be pregnant in 2016 . Cheers !
O O O O O O O O O O O O O O O O O O O O O O O O O O O O O O O O O	I love being up early making my man breakfast â£ ï¸I love taking him lunch and I LOVE having food for him when he gets home after a long day . ğŸ¤¤ ğŸ–¤
O O O O O O O O O O O O O O	What's your reason for celebrating ? What are you taking a vacation from ?
O O O O O O O O O	@USER EstÃ¡ , mas a fila estÃ¡ enorme .
O O	Wtf URL
O O O O O O O O O O O O O O O O O O	Oh my GAWD , @USER came over to watch Thomas and brought me @USER . # BestBabysitterEver URL
O O O O O O O O O O O O O O O O O	Ayo what time is you bed time ğŸ˜‚ ğŸ˜‚ ğŸ˜‚ ğŸ˜­ ğŸ˜­ ğŸ˜­ log off . URL
O O O O O O O O O O O O O O O O O O O O O	Not in content ( so far ) . Just the sound of their voices through a phone line are hella similar
O O O O O O O O	It's finally January ğŸ˜˜ couples more days now
O O O O O O O O O	are you going to breast feed â€” yes URL
O O	ğŸ˜ URL
O O O O O O O O	... but I'll take that . Aha .
O O O O O O O O O O O O O O O	@USER @USER I was still in elementary when i figured it out ğŸ˜­ ğŸ˜­ ğŸ˜­
O O O O O O	I remember we was little .
O O O O O O O O O O O O O O O	Teagan surprised me for my baby shower and I started crying . Bless her soul
